Gd, Gd, Gd, Gg, Gd, Gg^Xo, Rb^Xo, Isa, Rb, Isr, Isr, Isc, Isr, Isr, Re, Isa, Rb^Xo, Gd, Gd, Xom, Xom, Xom, Xom, Isa, Isa, Xom, Xom, Xom, Xom, Xom, Xom, Gg
Gs, Gd, Gg, Gd, Gd, Gd, Gd, Rb^Xo, Rb^Xo, Re, Re, Isc, Rb, Rb, Rb^Xo, Rb^Xo, Gg^Efm, Gg^Efm, Gs, Gs^Efm, Gg, Xom, Isa^Ebn, Isa, Isa, Isa, Isa, Xom, Xom, Xom, Xom, Xom
Gg, Gs^Fds, Gg, Gs^Fds, Gg, Gs, Hh, Gd, Hhd, Hhd^Xo, Hhd^Xo, Rb^Xo, Hhd^Xo, Hhd^Xo, Gs, Gg, Ss^Qhu, Gg, Gg, Gg^Efm, Ss^Qhu, Gg^Efm, Isa, Isa, Gg^Xo, Isa, Isa, Isr^Qhh, Xom, Xom, Xom, Xom
Gg, Gg, Gg, Gg, Gs^Fms, Gg^Fms, Hh^Fds, Hh^Fds, Hh, Hh^Fms, Hh^Fms, Hhd, Hhd, Hhd, Gs, Re, Re, Re, Gg, Rb, Rb, Re, Gg, Isa, Isa, Isa, Isa, Isr^Qhh, Xom, Xom, Xom, Xom
Gg, Gg^Fds, Gg^Fds, Gs^Fms, Gg^Fds, Gg^Fds, Gg, Hh^Fds, Hh^Fms, Rb, Ds, Hhd, Gg, Re, Dd, Gg, Dd, Ss^Qhu, Dd, Ww, Ww, Dd, Dd, Isa^Ebn, Gg, Isa, Xom^Efs, Xom, Xoi, Xoi, Xoi, Xom
Rb, Gs, Gs^Fds, Gg, Gg^Fds, Gg^Fds, Gg, Hh^Fds, Re, Ds, Ds, Re, Gg, Ss^Qhu, Dd, Dd, Dd, Dd, Ds, Ww, Ds, Dd, Gs, Gg, Gg, Isa, Isa, Xoi, Ql, Iwr^Efs, Iwr, Xoi
Gg, Re, Re, Rb, Gg, Gg, Rb, Re, Gs, Gg, Gg^Fds, Gg, Gg, Gg, Ss^Qhu, Dd, Ds, Ds, Ds, Ds, Ds, Wwf, Wwf, Gg, Re, Gg, Isa, Ql, Ql, Iwc^Efs, Iwr^Efs, Xoi
Gg^Fds, Gg, Gs, Re, Gg, Re, Gg^Fds, Gs, Gs^Fms, Gs, Gg^Fds, Gs, Ds, Gd, Wwf, Ds, Ww^Ewf, Ww, Ww, Ds, Ww, Wwf, Rb, Re, Gg, Isa, Xom, Xoi, Xoi, Iwr^Efs, Xoi, Xom
Gs, Gs^Fds, Gg, Gg^Fms, Gg, Gg, Gg^Fms, Gs^Fms, Gg, Gg, Gg^Fms, Ds, Wwf, Wwf, Ww^Ewf, Wo, Wo, Wo, Wo, Ww, Ww, Gg, Ds, Gd, Gs, Isa, Isa, Xom, Xom^Efs, Xoi, Xoi, Xom
Gg, Gg, Gg, Gs, Gg^Fds, Gg^Fms, Gs^Fms, Gs, Gg^Fms, Gg^Fds, Gg^Fms, Ds, Gg^Fms, Wwf, Ww, Ww, Wo, Wo, Wo, Wo, Ww, Ww, Ds, Ds, Gg^Efm, Gg, Gg^Efm, Isa, Isa, Isa, Isa, Xoi
Ds, Ds, Gs, Gg^Efm, Gs^Fds, Gg^Efm, Gg, Gg, Gg, Gg, Ds, Gg, Ww, Ww, Ww, Ww, Ww, Ww, Ww, Ww, Ww, Ww, Wwf, Gs, Wwf, Gg^Eff, Gg^Eff, Gd^Efm, Gd^Efm, Gg^Efm, Gs, Isa
Wwf, Wwf, Wwf, Gs, Ds, Gs, Gd, Gg, Dd, Dd, Ds, Ds, Ds, Ww, Ww, Ww, Ds, Ww, Ds, Ww, Ww, Ww, Ww, Wwf, Ww, Wwf, Ww, Gd^Eff, Gg^Eff, Gg^Eff, Dd, Gd
Ww, Wwf, Ww, Wwf, Ww, Ds, Ds, Gd, Ww, Dd, Ww, Ww, Ww, Ww, Ww, Ds, Dd, Gs, Ds, Ww, Ww, Ww, Ww, Ww, Ww, Ww, Ww, Ww, Ww, Ds, Ds, Dd
Wo, Ww, Wo, Ww, Ww, Ww, Ww, Ww, Wo, Ww, Ww, Wo, Wo, Ww, Ww, Wwf, Ww, Dd, Gd, Gd, Ds, Ww, Ww, Ww, Wo, Ww, Wo, Ww, Ww, Ww, Ww, Dd
Wo, Wo, Wo, Wo, Ww, Ww, Ww, Wo, Wo, Ww, Wo, Wo, Wo, Wo, Ww, Ww, Wwf, Dd, Ww, Ds, Wo, Ww, Wo, Wo, Wo, Wo, Wo, Wo, Wo, Wo, Wo, Ww
Wo, Wo, Wo, Wo, Wo, Ww, Ww, Wo, Wo, Wo, Wo, Wo, Wo, Wo, Wo, Ww, Ww, Ww, Ww, Ww, Wo, Wo, Wo, Wo, Wo, Wo, Wo, Wo, Wo, Wo, Wo, Wo
Wo, Wo, Wo, Wo, Wo, Wo, Wo, Wo, Wo, Wo, Wo, Wo, Wo, Wo, Wo, Wo, Wo, Wo, Wo, Wo, Wo, Wo, Wo, Wo, Wo, Wo, Wo, Wo, Wo, Wo, Wo, Wo
