Gd^Qhux, Ww^Qhux, Wwf^Qhux, Re^Qhux, Gd^Qhux, Re^Qhux, Re^Qhux, Re^Qhux, Re^Qhux, Gs^Qhux, Gs^Qhux, Gs^Qhux, Gs^Qhux, Re^Qhux, Gs^Qhux, Gs^Qhux, Gs^Qhux, Gs^Qhux, Gs^Qhux, Gs^Qhux, Gs^Qhux, Ww^Qhux, Wwf^Qhux, Gs^Qhh, Ds, Gg, Ds, Ds, Ds, Gg, Re, Rb
Ww^Qhux, Gd^Qhux, Wwf^Qhux, Re^Qhux, Ww^Qhux, Wwf^Qhux, Gd^Qhux, Gs^Qhux, Gs^Qhh, Gs^Qhh, Gs^Qhh, Gd^Qhux, Gg^Qhh, Gd^Qhux, Gd^Qhux, Gd^Qhux, Gd^Qhux, Gd^Qhux, Wwf^Qhux, Gd^Qhux, Ww^Qhux, Re^Qhux, Gg^Qhh, Gs^Qhh, Gs^Efm, Gs, Gg, Ds, Re, Re^Vwm, Re, Rb
Ww^Qhux, Ww^Qhux, Ww^Qhux, Ww^Qhux, Re^Qhux, Ww^Qhux, Re^Qhux, Re^Qhux, Gs^Qhh, Gs, Gg^Fds, Gs^Qhh, Ce, Gg^Qhh, Gg^Qhh, Gs^Qhux, Re^Qhux, Re^Qhux, Re^Qhux, Ww^Qhux, Gg^Qhh, Gs^Qhh, Gs^Efm, Gs^Efm, Gs, Rb, Rb, Gg, Rb, Gs, Re^Gvs, Rb^Gvs
Gs^Qhux, Wwf^Qhux, Gs^Qhux, Wwf^Qhux, Gd^Qhux, Re^Qhux, Gs^Qhh, Gs^Qhh, Gs, Gs, Re, Gg^Fds, Ke, Ce, Gs^Qhh, Re^Qhux, Gs^Qhh, Gs^Qhh, Gs^Qhh, Gs^Qhh, Rb^Gvs, Rb, Rb, Rb, Gs^Efm, Rb, Gs, Rb, Rb^Gvs, Rb^Gvs, Re^Gvs, Rb^Gvs
Gs^Qhux, Gs^Qhux, Gg^Qhh, Gs^Qhux, Gs^Qhh, Gs^Qhh, Gg^Vl, Gg^Fms, Gg^Fms, Gs, Re, Re, Re, Ce, Gg, Gg^Qhh, Gg^Efm, Gs^Efm, Gs^Vh, Rb^Gvs, Re, Gs, Re^Gvs, Rb, Re^Eff, Gs^Efm, Gs, Gg, Re, Re^Gvs, Gg, Gs^Efm
Re^Qhh, Gg^Qhh, Rb, Gg^Qhh, Rb, Gs, Gg^Fds, Gg^Fms, Gg^Fds, Re, Rb, Gg^Fds, Gg, Rb, Rb, Re, Re, Rb, Re, Re, Rb^Gvs, Rb^Gvs, Re^Gvs, Re^Gvs, Gs^Eff, Gs^Eff, Gs, Gg, Gd, Re, Hh, Hh^Edt
Gs, Re, Gs, Re, Re, Re, Rb, Gs, Re, Rb, Gg, Gs, Gg, Gs, Gg, Gs^Fms, Gs^Efm, Gs^Efm, Gs^Fds, Re^Gvs, Re^Gvs, Rb^Gvs, Re^Eff, Re^Eff, Hh, Gs, Gs, Gs, Hh^Edt, Gs, Hh, Gs
Gs, Gs, Ds, Gs, Gs, Gs, Gs, Gs, Gg, Gg, Gs, Gg, Gg, Gg, Gg, Gs^Fds, Gs, Gll^Fp, Hh, Re, Gs^Vhr, Gs, Gs, Gg, Gg, Gs, Hh^Edt, Gs, Gd, Hh^Edt, Gs, Hh^Edt
Gs, Ds, Ds, Ds, Ds, Ds, Ds, Gs, Gs, Gs, Gs, Gg, Gs, Hh, Hh, Gs, Gs, Gs, Gs, Hh, Gg, Gs, Hh, Gg, Gg, Hh, Gs, Gd^Edt, Gd^Edt, Gd^Edt, Gs^Edt, Gs^Edt
Ds, Ds, Ww, Ww, Ww, Ds, Gs, Ds, Gd, Gd^Edt, Gd, Gd, Gg^Fds, Hh, Gs^Fms, Gs^Es, Gs, Gg, Gg^Fms, Gg, Gs, Gs, Gg, Gg, Gg, Gg, Gg, Gs, Gs, Gd^Fp, Gll^Fp, Gll^Fp
Ww, Ww^Ewl, Ww, Ww^Ewf, Wo, Ds^Qhh, Hh, Gs, Gd^Ecf, Gd, Gd^Edt, Gg^Fms, Gs, Gs, Gs, Gs, Gs, Gs, Gll^Fp, Gll^Fp, Gll^Fp, Hh^Fds, Hh, Hh, 2 Cer, Gg, Hh^Edt, Gs, Gll^Fp, Gs^Ecf, Gs, Gs
Ww, Wo, Wo, Wo, Hh^Qhh, Hh^Qhh, Hh^Es, Gs^Edt, Gs, Gs, Gs^Edt, Gs^Edt, Gs^Fds, Gs, Gs, Gs, Gs, Gg^Fms, Gs^Es, Gg^Fms, Gg^Fms, Gs^Edt, Hh, Cer, Cer, Hh, Hh^Fds, Hh^Fp, Hh^Fp, Gll^Fp, Hh^Fms, Hh^Fms
Ww, Ww, Wo, Wo, Hh^Qhh, Hh, Gs, Hh, Gg^Edt, Hh^Es, Hh, Gg, Hh, Hh, Hh, Gs, Gg^Vl, Gs^Es, Gs^Es, Gs, Gg^Ecf, Hh^Fms, Hh^Fds, Hh^Fms, Gs, Hh^Edt, Hh^Fms, Hh^Fp, Hh^Fds, Hh^Fds, Hh^Fds, Hh^Fds
Wo, Wo, Hh^Qhh, Hh^Qhh, Hh^Qhh, Gs, Hh^Es, Hh^Es, Hh^Es, Gs, Hh, Gs, Gs, Gs, Gs, Hh, Hh, Hh^Fds, Gs, Hh^Fms, Gs, Gs, Gs^Fp, Hh^Edt, Hh^Fp, Gs^Edt, Gs^Edt, Gs, Gll^Fp, Gs, Gs, Gs
Gs^Qhh, Hh^Qhh, Hh^Qhh, Hh^Qhh, Hh^Qhh, Gs, Gs, Gs, Gs, Hh, Hh, Gs, Gs, Gs, Hh, Gs, Gs, Gs^Fds, Gs, Gs^_mh, Gs, Hh, Hh^Fp, Gs, Gs, Hh^Fp, Gs, Gll^Fp, Gs, Gll^Fp, Gll^Fp, Gll^Fp
