Aa, Aa^Esa, Aa^Esa, Gg, Aa, Gg, Gg, Gg, Gg, Gg, Aa^Esa, Aa, Wwg^Qhu, Wog^Qhu, Wog^Qhux, Wog^Qhux, Aa^Qhux, Gg, Aa^Fpa, Gg, Gg, Rb, Re, Aa, Gll^Fdf, Gg, Aa, Aa, Aa^Fpa, Gg
Gd, Aa, Aa^Esa, Aa, Gd, Aa, Gs^Em, Gg, Gg, Aa, Aa, Wwg^Qhu, Wog^Qhux, Wwg^Qhu, Aa^Qhux, Aa^Qhux, Aa^Fpa, Aa, Gll^Fdf, Gll^Fdf, Gll^Fdf, Rb, Re, Rb^Ve, Rb, Gll^Fmf, Gll^Fmf, Aa^Fpa, Aa^Fpa, Aa
Gg, Gg, Gd, Gd, Gg, Gg^Em, Gg^Em, Aa, Gd, Aa^Esa, Wwg^Qhu, Wog^Qhu, Wog^Qhux, Wwg^Qhux, Aa^Qhux, Aa^Qhux, Rb, Aa, Aa, Gs, Rb, Gs, Re, Gg^Fet, Rb, Gll^Fdf, Gll^Fdf, Aa^Fda, Gg, Aa^Fpa
Aa, Aa^Esa, Aa^Esa, Gg, Gs, Aa^Esa, Aa, Aa, Aa, Aa, Wwg^Qhu, Wog^Qhu, Wwg^Qhux, Aa^Qhux, Gs, Aa, Rb, Rb, Aa, Aa, Gg, Gs, Aa^Fma, Rb, Gg^Ve, Rb, Gg, Gll^Fdf, Gll^Fmf, Gll^Fdf
Aa, Gd, Aa, Gs, Ds, Aa, Ds, Aa, Wwg^Qhu, Wwg^Qhu, Wwg^Qhu, Wwg^Qhu, Wwg^Qhux, Rb, Aa^Esa, Aa, Aa^Fda, Gs, Gll^Fmf, Gll^Fmf, Aa^Fda, Gg, Gll^Fmf, Aa^Fma, Aa^Fpa, Gll^Fmf, Re, Gll^Fmf, Gll^Fdf, Gll^Fdf
Gd, Gd, Gd, Ds, Ds, Ds^Do, Ds, Wwg^Qhu, Wwg^Qhu, Wog^Qhux, Wwg^Qhux, Wwg^Qhux, Aa^Fpa, Rb, Aa, Aa^Esa, Gs^Fdf, Gll^Fmf, Gs, Aa^Fda, Gll^Fmf, Gll^Fdf, Aa^Fma, Aa^Fpa, Aa^Fda, Gll^Fdf, Re, Re, Gll^Fmf, Gll^Fdf
Gs^Em, Gd^Em, Gs, Ds, Gd, Ds, Wwg^Qhu, Wwg^Qhu, Wwg^Qhux, Wog^Qhux, Wwg^Qhux, Wwg^Qhux, Aa^Fda, Aa, Aa^Esa, Aa^Esa, Aa, Gll^Fmf, Gs, Gll^Fmf, Gll^Fmf, Gll^Fdf, Gll^Fmf, Gg, Gg^Fmf, Gg, Re, Gll^Fdf, Gll^Fmf, Aa^Fda
Gs, Gg, Aa^Esa, Gg, Wwg^Qhu, Wwg^Qhu, Wwg^Qhu, Wog^Qhu, Wwg^Qhux, Wwg^Qhux, Aa^Qhux, Aa^Fma, Gll^Fdf, Aa, Gs, Aa, Gs, Gs, Gs, Gs, Gs, Gll^Fdf, Gs, Gll^Fmf, Gll^Fdf, Gll^Fdf, Gg, Gg, Gll^Fdf, Gg
Gg, Gd, Gg^Em, Aa, Wwg^Qhu, Wwg^Qhux, Wwg^Qhux, Wwg^Qhux, Wwg^Qhux, Aa^Qhux, Aa, Aa, Aa, Gll^Fmf, Gll^Fmf, Gll^Fmf, Aa, Aa, Aa, Aa, Gll^Fmf, Gs, Gll^Fdf, Gg, Re, Re, Gll^Fdf, Gll^Fmf, Gll^Fmf, Gll^Fdf
Ds, Gd, Ds, Wwg^Qhu, Wog^Qhu, Wog^Qhux, Wwg^Qhux, Wwg^Qhux, Gg^Fmf, Gll^Fdf, Gs, Gll^Fmf, Gg, Gg, Gg, Aa, Aa, Aa, Gg, Aa^Fda, Re^Vl, Gg^Fmf, Gg^Fmf, Rb, Gg, Gll^Fdf, Aa^Fda, Aa^Fma, Aa^Fda, Gll^Fdf
Ds, Ds, Wog^Qhu, Wog^Qhu, Wog^Qhu, Wwg^Qhux, Wwg^Qhux, Gg^Fmf, Gll^Fdf, Gg, Gll^Fdf, Gg, Gg, Gg, Gll^Fdf, Gg, Gg, Gg, Gg^Fmf, Gll^Fmf, Gg, Gg^Fmf, Gg, Re, Aa^Fma, Gg^Fmf, Gg, Gg, Gg, Gg
Ds, Wwg^Qhu, Wog^Qhux, Wog^Qhu, Wwg^Qhux, Wwg^Qhux, Rb, Gll^Fdf, Gg, Gs, Gs, Gs, Gs, Gg^Fmf, Gg^Fmf, Gg, Gg^Fmf, Gg, Gll^Fdf, Gg^Fmf, Gg, Rb, Gg, Gg, Aa, Gll^Fmf, Gll^Fmf, Gll^Fmf, Gg^Es, Gll^Fdf
Wwg^Qhu, Wwg^Qhu, Wog^Qhux, Wog^Qhux, Wwg^Qhux, Rb, Rb, Rb, Gg, Gg, Gg, Gs, Gs, Gs, Gs, Gs, Gs, Gll^Fdf, Gs, Gs, Re, Re, Gs, Gg^Fmf, Gg, Gll^Fmf, Aa, Gg, Gg, Hh^Es
Wwg^_ml, Wog^Qhux, Wwg^Qhux, Wwg^Qhux, Gs, Re, Gg, Gg, Gg, Gg, Gg, Gg, Gg, Gs, Gg, Gll^Fdf, Gs, Re, Re, Re, Gd, Gg^Fmf, Aa^Fma, Aa^Fma, Gd, Aa, Gd, Aa, Ha, Gg
Wwg^Qhux, Wog^Qhux, Wwg^Qhux, Wwg^Qhux, Gs, Gg, Gs, Gll^Fdf, Gs, Gg, Gs, Gs, Gg, Gg^Fmf, Gg, Gg, Gg, Re, Gg, Gg^Fmf, Gd, Gg, Aa, Aa, Gg^Es, Gs, Gs, Gs, Gd, Hh
Wwg^Qhux, Wog^Qhu, Wwg^Qhux, Wwg^Qhux, Re, Gg, Gg, Gg, Gg, Gs, Gg^Fmf, Gg, Gg, Rb, Gg, Rb, Gg, Gs, Gd, Gg^Fmf, Gs, Aa, Gd, Hh^Es, Hh, Gd, Ha, Hh^Es, Aa, Hh^Es
Wwg^Qhux, Wwg^Qhux, Wwg^Qhux, Wwg^Qhux, Rb^Edt, Re, Gg^Edt, Gg, Gg, Gg, Gg^Dr, Gg, Rb, Gg, Gg, Gg, Gg, Gg^Es, Gd, Gd, Gg, Gs, Gd, Hh, Gd, Hh^Es, Mm, Ms, Ha, Gg
Wog^Qhu, Wog^Qhu, Wwg^Qhux, Rb^Eb, Chr^Edt, Chr, Rb^Dr, Rp^Edt, Rp, Gs, Re, Re, Chr^Edt, Gg, Gg^Efm, Gs, Gg^Efm, Gg^Efm, Ww, Gg, Gg^Efm, Gs^Es, Gs, Gd, Gs, Hh, Hh, Ha, Aa^Vha, Gg
Wog^Qhux, Wwg^Qhux, Wwg^Qhu, Wwg^Qhux, Rb^Dr, Khr, Chr^Edt, Gg, Rp, Gs, Re, Rb, Gg, Gg^Efm, Gg^Efm, Gs, Gg^Efm, Ww, Wo, Ww, Hh^Efm, Gg^Es, Gg^Efm, Gg, Gg^Es, Hh, Gs, Hh, Aa, Ha
Wwg^Qhux, Wog^Qhux, Wog^Qhux, Wwg^Qhux, Wwg^Qhux, Rp^Vhcr, Rp^Edt, Rp, Gs, Gs, Gs, Gg, Gg, Gg, Gs, Gg^Efm, Ww, Ww, Wo, Wo, Wo, Ww, Hh, Hh, Gg, Gg, Hh^Es, Gs^Es, Hh, Gd
Wwg^Qhu, Wwg^Qhux, Wwg^Qhu, Wwg^Qhux, Wwg^Qhux, Wwg^Qhux, Gg, Gs, Gs, Gs, Re, Re^Dr, Gg, Gs, Gg^Es, Gg^Efm, Ww, Ww, Hh, Ww, Wwf, Ww, Hh, Gg, Hh, Hh, Hh, Gg, Mm, Gg
Ds, Wwg^Qhu, Wwg^Qhu, Wog^Qhu, Wwg^Qhu, Wwg^Qhux, Wwg^Qhux, Gg^Edt, Gg, Gg, Gg, Rb, Gg, Gg, Gg, Gg^Efm, Hh, Hh^Es, Mm, Hh, Hh, Wwf, Gg^Es, Hh, Mm, Gg, Hh, Hh, Mm^Xm, Mm
Gd, Gd, Ds, Wwg^Qhu, Wwg^Qhux, Wwg^Qhux, Wwg^Qhux, Wwg^Qhux, Gg, Gg, Gg, Re, Rb, Gg, Gg^Eff, Gg^Eff, Rb^Gvs, Gg, Hh, Hh^Es, Hh, Wwf, Hh^Es, Hh^Es, Gg, Hh, Hh^Es, Mm, Mm, Mm^Xm
Gd, Ds, Ds, Wwg^Qhu, Wwg^Qhu, Wog^Qhux, Wog^Qhux, Wwg^Qhux, Gg^Efm, Gg, Gg, Gg, Gg^Eff, Gg^Eff, Rb^Gvs, Rb^Gvs, Rb^Gvs, Gg^Vh, Gg, Gg, Mm, Ww, Ww, Hh, Mm, Mm, Hh, Hh, Hh, Mm^Xm
Gd, Gd^Fetd, Gd, Ds^Ewsh, Wwg^Qhu, Wog^Qhux, Wog^Qhux, Wwg^Qhux, Wwg^Qhux, Gg^Efm, Gg, Re, Gg, Gg^Eff, Rb^Gvs, Re^Gvs, Rb^Gvs, Rb, Gs, Hh, Hh^Es, Hh, Hh, Ww, Mm, Mm^Xm, Hh^Es, Mm, Mm, Mm
Gs, Gd, Gs, Gs, Wwg^Qhu, Wwg^Qhux, Wog^Qhux, Wwg^Qhux, Wwg^Qhux, Gg, Gs, Gg, Rb, Gg, Re, Re^Gvs, Rb, Rb, Gg, Gg, Gs, Hh^Es, Gg, Ww, Ww, Hh, Wwf, Wwf, Hh, Mm^Xm
Ds, Ds, Ds^Ftd, Ds, Wwg^Qhu, Wwg^Qhu, Wwg^Qhux, Wwg^Qhux, Gg^Efm, Gg^Efm, Gs^Efm, Gg, Gg, Rb, Gg, Re, Gg, Gg, Hh^Es, Hh, Gs, Gg^Es, Hh^Es, Gg, Mm, Ww, Mm, Hh, Hh, Mm
Ds, Ds^Ftd, Ds^Ftd, Wwg^Qhu, Wog^Qhux, Wog^Qhu, Wwg^Qhux, Wwg^Qhux, Gg^Efm, Gs, Gg, Gs, Gg, Re, Gg, Gg, Gg^Efm, Gg^Efm, Gg^Efm, Gg, Hh, Hh, Gg, Hh, Mm, Mm, Mm^Xm, Hh, Gg, Mm^Xm
