Gs^Fds, Gs^Fds, Gs^Fds, Gll^Fp, Gs^Fds, Gg, Gll^Fp, Gg, Gg, Gs^Fds, Gg, Gs^Fds, Gs^Fds, Gs^Fds, Gs^Fds, Gs^Fds, Gg, Wwg, Wwg, Wwg, Wwg, Wo, Wo, Gg, Gll^Fp, Gll^Fp, Gll^Fp, Gg
Gs^Fds, Gll^Fp, Gll^Fp, Gs^Fms, Gs^Fds, Gs^Fds, Gg, Gs^Fds, Gg, Gs^Fds, Gg, Gs^Fds, Gg, Gs^Fds, Gs, Gg, Gs, Gll^Fp, Gs, Wwg, Wwg, Wo, Wo, Wo, Gg, Gg, Gs^Fms, Gg
Gg, Gll^Fp, Gs^Fds, Gg, Gg, Gg, Rrd, Gs, Urc^Ii, Wo, Wo, Gg, Wo, Gs, Wo, Wo, Wo, Gs, Wo, Gs, Wo, Wo, Wo, Urc^Ii, Rrd, Gs^Fds, Gg, Gs^Fds
Gs^Fds, Gg, Gs, Gs^Fds, Gg, Rrd, Rrd, Rrd, Wo, Wo, Wo, Wo, Wo, Wo, Wo, Gg^Fet, Wo, Wo, Wo, Wo, Wo, Wo, Rrd, Rrd, Rrd, Gg, Rrd, Gg
Gg, Gg, Gs, Gs, Rrd, Rrd, Gs^Fms, Gg, Wo, Gg, Gll^Fp, Gs^Fds, Gs^Fds, Wo, Urc^Ii, Wo, Wo, Gg^Do, Gg, Wo, Gg, Gg, Rrd, Rrd, Rrd, Rrd, Rrd, Wog^Qhu
Gll^Fp, Gg, Gs^Fds, Gg, Rrd, Gs^Fds, Gll^Fp, Gg, Wo, Gs, Gs, Gll^Fp, Rrd, Rrd, Gs, Wo, Gg, Gs^Fms, Gs^Fms, Gs^Fp, Gs^Fds, Gg, Gll^Fp, Gs^Fds, Gg, Rrd, Gs, Wog^Qhu
Gs^Fds, Gll^Fp, Gs^Fp, Gg, Rrd, Rrd, Gg, Gg, Gs^Fds, Wo, Wo, Gs, Rrd, Rrd, Qxu, Wo, Wo, Gll^Fp, Gg, Gs^Fp, Rrd, Gg, Wwrg^Qhux, Wwrg^Qhux, Wog^Qhu, Gs, Gs^Fms, Gs^Fds
Gg, Gs^Fms, Gs^Fds, Gg, Wwrg^Qhux, Rrd, Gs^Fds, Gs, Gs^Fds, Gg^Fet, Wo, Gg, Xot, Qxu, Xot, Qxu, Qxu, Gs^Fds, Gg^Fet, Rrd, Rrd, Gs^Fds, Gg, Wot^Qhu, Wo, Wot^Qhux, Gs^Fms, Gg
Gs, Gg, Wwrg^Qhux, Gg^Fet, Wo^Qhu, Wwrg^Qhux, Wot^Qhu, Gg, Gs, Gs^Fds, Wo, Isa, Isa, Xot, Isa, Qxu, Rrd, Gg, Rrd, Rrd, Rrd, Rrd, Rrd, Urc^Ii, Wo, Gg, Gll^Fp, Gs^Fms
Wwrg^Qhux, Wo^Qhu, Wo^Qhu, Wwrg^Qhux, Wot^Qhu, Wo^Qhu, Wot^Qhux, Gg, Gg, Gg, Xot, Wo, Wo^Qhux, Rrd^Qhux, Rrd^Qhux, Rrd, Xot, Rrd, Gll^Fp, Gs^Fds, Gs, Gg^Fet, Gs^Fds, Rrd, Wo, Wo, Wo, Wo
Wot^Qhux, Wot^Qhu, Wot^Qhux, Gg, Gg, Wot^Qhux, Gg, Wo, Wo, Xot, Xot, Wo^Qhux, Dd^Qhux, Isr^Eb, Rrd^Qhux, Rrd^Qhux, Xot, Xot, Rrd, Gs^Fds, Rrd, Rrd, Rrd, Wo, Gg, Wo, Wo, Wo
Gg, Gg, Gs, Gs^Fds, Gs^Fms, Gg, Gs^Do, Gg, Wo, Wo, Gg, Rrd, Isa, Rrd^Qhux, Isa, Rrd, Rrd, Rrd, Urc^Ii, Rrd, Gg, Rrd, Urc^Ii, Wo, Gs^Fms, Gs^Fms, Gs^Fms, Gs^Fds
Gs^Fds, Gs^Fds, Gs, Gs, Gs, Gs^Fms, Gs^Fds, Gg^Fet, Urc^Ii, Wo, Rrd, Rrd, Xot^Dr, Xot, Xot, Gs^Fms, Gs^Fds, Rrd, Rrd, Gs^Fds, Gs^Fms, Gs^Fds, Gg, Wo, Wo, Gll^Fp, Gg, Gs^Fds
Gs^Fds, Gll^Fp, Gll^Fp, Gs^Fms, Gs^Fms, Gg, Gs^Fms, Gg, Wo, Wo, Gs^Fds, Gg, Gg, Gg, Wo^Qhux, Gll^Fp, Gg^Fet, Rrd, Wog^Qhu, Gs^Fds, Gs^Fds, Gll^Fp, Gg^Do, Wo, Wo, Gll^Fp, Gs^Fds, Wo
Gg, Gg, Gs^Fds, Gg, Gs^Fms, Gs^Fds, Gg, Wo, Wo, Gs^Fms, Gg, Gg^Fet, Rrd, Rrd, Wo^Qhu, Wot^Qhux, Wot^Qhu, Wwrg^Qhux, Wwrg^Qhux, Wo, Wo, Gg, Rrd, Gg, Wwrg^Qhux, Wo, Wog^Qhu, Wot^Qhux
Wwg, Gg, Gs, Gs, Gs^Fms, Gs^Fds, Wo, Wo, Rrd, Gs^Fms, Rrd, Rrd, Gg, Gs^Fds, Wo, Wwrg^Qhux, Wog^Qhu, Wog^Qhu, Gs^Fms, Wo, Wo, Gg, Rrd, Rrd, Rrd, Wwrg^Qhux, Wot^Qhu, Wog^Qhu
Wo, Wwg, Gs^Fms, Gs^Fds, Gg^Fms, Wo, Wo, Urc^Ii, Gs^Fds, Rrd, Gg, Rrd, Gs^Fms, Gg, Wo, Wo, Wo, Gs^Fds, Gs, Gs, Gs^Fms, Wo, Urc^Ii, Rrd, Gg, Wot^Qhu, Wwrg^Qhux, Wwrg^Qhux
Gg, Wo, Wo, Gs^Fms, Gg^Fds, Gg, Wo, Wo, Gs^Fms, Gs^Fms, Gg, Gll^Fp, Gs^Fms, Gg, Gs^Fds, Gg, Wo, Wo, Gs, Gll^Fp, Gs^Fms, Wo, Wo, Gs^Fds, Gll^Fp, Wo, Wo, Gs^Fds
Gs^Fds, Gg, Wo, Gs^Fp, Wo, Gll^Fp, Wo, Gg, Gs^Fds, Gg, Gs, Gll^Fp, Gg, Rrd, Rrd, Rrd, Wo, Urc^Ii, Wo, Gs^Fds, Wo, Wo, Wwg, Wo, Wo, Wo, Wo, Gll^Fp
Gs^Fds, Gs^Fds, Wwg, Wo, Wwg, Wo, Gs^Fds, Gg, Gll^Fp, Gg, Gs, Gg, Rrd, Rrd, Gg, Rrd, Gg, Wo, Wo, Wo, Wwg, Gg^Fet, Wwg, Wo, Wwg, Wwg, Wwg, Wo
Gll^Fp, Gll^Fp, Gll^Fp, Gg, Gg, Wwg, Gg, Gg, Gs^Fms, Gs^Fms, Gs^Fds, Gs, Rrd, Rrd, Gll^Fp, Gs, Gs, Wwg, Gs^Fds, Wwg, Gs^Fms, Wwg, Wo, Wwg, Wo, Gll^Fp, Gll^Fp, Wo
Gs^_s, Gs^_s, Gs^_s, Gs^_s, Gg^_s, Gs^_s, Gs^_s, Gs^_s, Gg^_s, Gg^_s, Wog^_s, Wog^_s, Wog^_s, Gs^_s, Gs^_s, Gs^_s, Gs^_s, Gs^_s, Gs^_s, Gs^_s, Gs^_s, Wwg^_s, Wo^_s, Wo^_s, Wwg^_s, Wo^_s, Gg^_s, Gs^_s
