Gs^Fds, Gs^Fds, Gs^Fds, Gll^Fp, Gs^Fds, Gg, Gll^Fp, Gg, Gg, Gs^Fds, Gg, Gs^Fds, Gs^Fds, Gs^Fds, Gs^Fds, Gs^Fds, Gg, Wwg, Wwg, Wwg, Wwg, Wo, Wo, Gg, Gll^Fp, Gll^Fp, Gll^Fp, Gg
Gs^Fds, Gll^Fp, Gll^Fp, Gs^Fms, Gs^Fds, Gs^Fds, Gg, Gs^Fds, Gg, Gs^Fds, Gg, Gs^Fds, Gg, Gs^Fds, Gs, Gg, Gs, Gll^Fp, Gs, Wwg, Wwg, Wo, Wo, Wo, Gg, Gg, Gs^Fms, Gg
Gg, Gll^Fp, Gs^Fds, Gg, Gg, Gg, Dd, Gs, Urc^Ii, Wo, Wo, Gg, Wo, Gs, Wo, Wo, Wo, Gs, Wo, Gs, Wo, Wo, Wo, Urc^Ii, Dd, Gs^Fds, Gg, Gs^Fds
Gs^Fds, Gg, Gs, Gs^Fds, Gg, Dd, Dd, Dd, Wo, Wo, Wo, Wo, Wo, Wo, Wo, Gg^Fet, Wo, Wo, Wo, Wo, Wo, Wo, Dd, Dd, Dd, Gg, Dd, Gg
Gg, Gg, Gs, Gs, Dd, Dd, Gs^Fms, Gg, Wo, Gg, Gll^Fp, Gs^Fds, Gs^Fds, Wo, Urc^Ii, Wo, Wo, Gg^Do, Gg, Wo, Gg, Gg, Dd, Dd, Dd, Dd, Dd, Wog^Qhu
Gll^Fp, Gg, Gs^Fds, Gg, Dd, Gs^Fds, Gll^Fp, Gg, Wo, Gs, Gs, Gll^Fp, Dd, Dd, Gs, Wo, Gg, Gs^Fms, Gs^Fms, Gs^Fp, Gs^Fds, Gg, Gll^Fp, Gs^Fds, Gg, Dd, Gs, Wog^Qhu
Gs^Fds, Gll^Fp, Gs^Fp, Gg, Dd, Dd, Gg, Gg, Gs^Fds, Wo, Wo, Gs, Dd, Dd, Qxu, Wo, Wo, Gll^Fp, Gg, Gs^Fp, Dd, Gg, Wwrg^Qhux, Wwrg^Qhux, Wog^Qhu, Gs, Gs^Fms, Gs^Fds
Gg, Gs^Fms, Gs^Fds, Gg, Wwrg^Qhux, Dd, Gs^Fds, Gs, Gs^Fds, Gg^Fet, Wo, Gg, Xot, Qxu, Xot, Qxu, Qxu, Gs^Fds, Gg^Fet, Dd, Dd, Gs^Fds, Gg, Wot^Qhu, Wo, Wot^Qhux, Gs^Fms, Gg
Gs, Gg, Wwrg^Qhux, Gg^Fet, Wo^Qhu, Wwrg^Qhux, Wot^Qhu, Gg, Gs, Gs^Fds, Wo, Isa, Isa, Xot, Isa, Qxu, Dd, Gg, Dd, Dd, Dd, Dd, Dd, Urc^Ii, Wo, Gg, Gll^Fp, Gs^Fms
Wwrg^Qhux, Wo^Qhu, Wo^Qhu, Wwrg^Qhux, Wot^Qhu, Wo^Qhu, Wot^Qhux, Gg, Gg, Gg, Xot, Wo, Wo^Qhux, Dd^Qhux, Dd^Qhux, Dd, Xot, Dd, Gll^Fp, Gs^Fds, Gs, Gg^Fet, Gs^Fds, Dd, Wo, Wo, Wo, Wo
Wot^Qhux, Wot^Qhu, Wot^Qhux, Gg, Gg, Wot^Qhux, Gg, Wo, Wo, Xot, Xot, Wo^Qhux, Dd^Qhux, Isr^Eb, Dd^Qhux, Dd^Qhux, Xot, Xot, Dd, Gs^Fds, Dd, Dd, Dd, Wo, Gg, Wo, Wo, Wo
Gg, Gg, Gs, Gs^Fds, Gs^Fms, Gg, Gs^Do, Gg, Wo, Wo, Gg, Dd, Isa, Dd^Qhux, Isa, Dd, Dd, Dd, Urc^Ii, Dd, Gg, Dd, Urc^Ii, Wo, Gs^Fms, Gs^Fms, Gs^Fms, Gs^Fds
Gs^Fds, Gs^Fds, Gs, Gs, Gs, Gs^Fms, Gs^Fds, Gg^Fet, Urc^Ii, Wo, Dd, Dd, Xot^Dr, Xot, Xot, Gs^Fms, Gs^Fds, Dd, Dd, Gs^Fds, Gs^Fms, Gs^Fds, Gg, Wo, Wo, Gll^Fp, Gg, Gs^Fds
Gs^Fds, Gll^Fp, Gll^Fp, Gs^Fms, Gs^Fms, Gg, Gs^Fms, Gg, Wo, Wo, Gs^Fds, Gg, Gg, Gg, Wo^Qhux, Gll^Fp, Gg^Fet, Dd, Wog^Qhu, Gs^Fds, Gs^Fds, Gll^Fp, Gg^Do, Wo, Wo, Gll^Fp, Gs^Fds, Wo
Gg, Gg, Gs^Fds, Gg, Gs^Fms, Gs^Fds, Gg, Wo, Wo, Gs^Fms, Gg, Gg^Fet, Dd, Dd, Wo^Qhu, Wot^Qhux, Wot^Qhu, Wwrg^Qhux, Wwrg^Qhux, Wo, Wo, Gg, Dd, Gg, Wwrg^Qhux, Wo, Wog^Qhu, Wot^Qhux
Wwg, Gg, Gs, Gs, Gs^Fms, Gs^Fds, Wo, Wo, Dd, Gs^Fms, Dd, Dd, Gg, Gs^Fds, Wo, Wwrg^Qhux, Wog^Qhu, Wog^Qhu, Gs^Fms, Wo, Wo, Gg, Dd, Dd, Dd, Wwrg^Qhux, Wot^Qhu, Wog^Qhu
Wo, Wwg, Gs^Fms, Gs^Fds, Gg^Fms, Wo, Wo, Urc^Ii, Gs^Fds, Dd, Gg, Dd, Gs^Fms, Gg, Wo, Wo, Wo, Gs^Fds, Gs, Gs, Gs^Fms, Wo, Urc^Ii, Dd, Gg, Wot^Qhu, Wwrg^Qhux, Wwrg^Qhux
Gg, Wo, Wo, Gs^Fms, Gg^Fds, Gg, Wo, Wo, Gs^Fms, Gs^Fms, Gg, Gll^Fp, Gs^Fms, Gg, Gs^Fds, Gg, Wo, Wo, Gs, Gll^Fp, Gs^Fms, Wo, Wo, Gs^Fds, Gll^Fp, Wo, Wo, Gs^Fds
Gs^Fds, Gg, Wo, Gs^Fp, Wo, Gll^Fp, Wo, Gg, Gs^Fds, Gg, Gs, Gll^Fp, Gg, Dd, Dd, Dd, Wo, Urc^Ii, Wo, Gs^Fds, Wo, Wo, Wwg, Wo, Wo, Wo, Wo, Gll^Fp
Gs^Fds, Gs^Fds, Wwg, Wo, Wwg, Wo, Gs^Fds, Gg, Gll^Fp, Gg, Gs, Gg, Dd, Dd, Gg, Dd, Gg, Wo, Wo, Wo, Wwg, Gg^Fet, Wwg, Wo, Wwg, Wwg, Wwg, Wo
Gll^Fp, Gll^Fp, Gll^Fp, Gg, Gg, Wwg, Gg, Gg, Gs^Fms, Gs^Fms, Gs^Fds, Gs, Dd, Dd, Gll^Fp, Gs, Gs, Wwg, Gs^Fds, Wwg, Gs^Fms, Wwg, Wo, Wwg, Wo, Gll^Fp, Gll^Fp, Wo
Gs^_s, Gs^_s, Gs^_s, Gs^_s, Gg^_s, Gs^_s, Gs^_s, Gs^_s, Gg^_s, Gg^_s, Wog^_s, Wog^_s, Wog^_s, Gs^_s, Gs^_s, Gs^_s, Gs^_s, Gs^_s, Gs^_s, Gs^_s, Gs^_s, Wwg^_s, Wo^_s, Wo^_s, Wwg^_s, Wo^_s, Gg^_s, Gs^_s
