Gg^Qhh, Gg^Qhh, Gg^Qhh, Gg^Qhh, Gg^Qhh, Gg^Qhh, Mm^Qhh, Gs^Qhh, Hh^Qhh, Gs^Efm, Ww, Gg, Hh, Gg, Hh, Gs, Gg^Efm, Hh, Hh, Hh, Mm, Mm, Mm, Hh, Mm, Mm, Mm, Gg^Qhh, Hh^Qhh, Hh, Gg, Gs^Fms, Gg, Gs^Fds, Gs^Fms, Gg, Gs^Fds
Gg^Qhh, Gg^Efm, Gg^Efm, Gg^Efm, Gg^Qhh, Gg^Efm, Hh^Qhh, Hh^_mhh, Mm^_mhh, Hh^Qhh, Hh^Qhh, Ww, Wo, Hh, Hh, Gs, Gg, Gs^Efm, Gg, Hh, Gg, Co, Co^Edt, 4 Ko, Co^Edt, Mm, Mm, Mm, Mm, Hh, Hh, Gs^Fms, Gs^Fds, Gg, Gg, Gs^Fms, Gg
Hh^Qhh, Hh^Qhh, Hh^Qhh, Gg^_mhh, Gg^_mhh, Gg^_mhh, Hh^Qhh, Hh^_mhh, Hh^Qhh, Mm^_mhh, Mm^_mhh, Hh^Qhh, Wo, Gg, Hh, Hh, Hh, Gg^Efm, Gg, Gg^Efm, Gg^Efm, Gg^Efm, Gg^Efm, Co^Edt, Gg^Edt, Hh, Hh, Mm, Hh, Hh, Hh, Gg, Gg, Gg, Gg, Gg, Gs^Fms
Hh^Qhh, Hh^Qhh, Hh^Qhh, Gg^Qhh, Gg^Efm, Gg^Efm, Hh^Qhh, Mm^_mhh, Mm^Qhh, Hh^Qhh, Mm^Qhh, Mm^Qhh, Hh^Qhh, Wo, Gg, Gg, Gg, Gg, Gg, Gg, Gg, Gg, Gg, Gg, Gs, Gg, Gg, Gg, Gg, Gg, Gg, Hh, Gg, Gg, Gg^Vl, Gs^Fms, Gs^Fms
Mm^Qhh, Mm^Qhh, Hh^Qhh, Gg^Qhh, Hh^Qhh, Gg^Qhh, Hh^Qhh, Hh^_mhh, Mm^_mhh, Hh^Qhh, Mm^_mhh, Hh^_mhh, Hh^Qhh, Ww, Ww, Gg, Hh, Gg, Hh, Hh^Edt, Hh, Hh, Mm, Hh, Gs, Gs, Hh, Co, Hh, Gg, Gg, Gg, Gg, Hh, Hh, Gs^Fds, Hh
Hh^Qhh, Mm^_mhh, Hh^Qhh, Gg^Qhh, Mm^_mhh, Hh^Qhh, Hh^Qhh, Mm^Qhh, Mm^Qhh, Hh^_mhh, Hh^Qhh, Mm^_mhh, Mm^_mhh, Hh^Qhh, Hh, Ww, Ww, Hh, Mm, Mm, Hh, Mm, Hh^Vo, Wwf, Wwf, Gg^Efm, Wo, Mm, Mm, Hh, Hh, Gg, Gg, Gg^Efm, Cer, Mm, Mm
Hh^Qhh, Hh^Qhh, Hh^Qhh, Mm^Qhh, Mm^Qhh, Mm^Qhh, Mm^Qhh, Mm^_mhh, Mm^Qhh, Mm^Qhh, Hh, Mm^Qhh, Mm^Qhh, Mm^Qhh, Hh, Gg^Efm, Mm, Wo, Wo, Ww, Ww, Hh^Edt, Wwf, Wwf, Ww, Ww, Wo, Wo^Ewf, Hh, Mm, Mm, Gg, Gs, Gg, Cer, 5 Ker, Cer
Rb, Re, Gs, Hh^Qhh, Ww, Ww, Ww, Mm^Qhh, Mm, Hh, Hh^Edt, Hh^Edt, Hh^Vo, Mm, Hh, Hh, Mm, Hh^_mh, Hh, Mm, Wo, Ww, Mm, Mm, Mm, Wo, Wo, Wo, Wo^Ewl, Hh, Hh, Mm, Hh, Gs, Gs, Gs, Cer
Gg, Rb, Re, Gs, Ww, Wo, Wo, Wo, Wo, Mm, Hh, Hh, Hh^Edt, Gg^Edt, Mm, Mm, Mm^Qhh, Hh^Edt, Mm, Mm, Wo^Ewf, Ww, Ww, Mm, Wo, Wo, Wo, Wo, Hh^Edt, Gg, Hh, Mm, Mm, Hh, Hh, Gg^Efm, Gg^Efm
Gg, Gg, Rb, Co, Co, Wo^Bw/, Wo, Wo, Mm, Wo, Hh^Vo, Mm, Mm^Qhh, Mm, Mm^Qhh, Co^Qhh, Hhd^Edt, Mm^Qhh, Mm^Qhh, Mm^Qhh, Mm^Qhh, Wo^Ewl, Wo, Wo, Ww^Ewl, Ww, Hh^Qhh, Hh^Edt, Mm, Mm, Mm, Hh, Hh, Mm, Mm, Hh, Hh
Gg^Qhh, Gg, Gg, Rb, Co, 3 Ko, Co, Mm, Mm, Mm, Mm, Hh^Qhh, Hh^Edt, Hh^Qhh, Hhd, Hhd, Hhd^Edt, Hhd^Edt, Hhd, Hhd^Vo, Hh^Qhh, Mm^Qhh, Hh^Qhh, Hh^Qhh, Mm^Qhh, Hh^Qhh, Hhd^Vo, Hh^Qhh, Mm^Qhh, Mm, Hh, Hh, Mm, Mm, Mm, Mm, Hh
Hh^Qhh, Gg^Qhh, Gg, Gg^Vo, Re, Co, Gg, Hh, Hh, Hh, Hh, Mm^Qhh, Hhd^Edt, Hh^Edt, Hhd, Gs^Edt, Co, Md, Co, Hhd, Hhd^Edt, Hh^Qhh, Hh, Co, Gs, Hhd^Edt, Gd, Hh^Qhh, Co, Mm^Qhh, Hh^Qhh, Mm, Hh^Qhh, Mm, Hh^Qhh, Hh^Qhh, Gg^Qhh
Hh^Qhh, Hh^Qhh, Hh^Qhh, Gg, Gg, Re, Rb, Gs, Re, Gs, Hh, Hh^Qhh, Gg^Qhux, Hhd, Hh, Gs, Gd^Vo, Ko, 2 Co^Edt, Co^Dr, Gs^Edt, Gd^Edt, Gs, Gs, Gg^Edt, Gs, Gs, Gs, Gs, Hh, Hhd^Edt, Hh^Qhh, Hhd, Hh^Qhh, Re, Rb, Rb
Hh^Qhh, Mm^_mhh, Mm^_mhh, Hh^Qhh, Gs^Qhh, Gg, Re, Re, Rb, Hh, Hh^Qhux, Gg^Qhux, Hh^Qhux, Mm^Qhu, Co, Hhd, Co, Gd^Dr, Co^Edt, Gd, Gd, Gs, Gd, Gd, Gd^Dr, Hhd, Hhd, Gs, Gs, Gd^Edt, Gd^Edt, Gs^Edt, Gs, Gd, Re, Re, Rb
Mm^Qhh, Mm^_mhh, Hhd^Qhh, Hh^Qhh, Gs, Gg, Hh, Gs^Qhh, Hh^Qhux, Hh^Qhux, Mm^Qhux, Mm^Qhux, Hh^Qhux, Mm^Qhux, Mm^Qhux, Hh^Qhux, Hhd^Edt, Gs, Gd^Edt, Gd, Gd, Gs, Gd, Co^Dr, Ko, Md, Mm, Gd^Dr, Gs, Gd, Gs, Gs, Gg, Gs, Gs, Gd, Rb
Mm^Qhh, Mm^_mhh, Hhd^Qhh, Gs, Hhd, Hh, Gg^Qhux, Gg^Qhux, Mm^Qhux, Mm^Qhux, Mm^Qhux, Mm^Qhux, Hh^Qhux, Hh^Qhux, Mm^Qhux, Hh^Qhux, Hhd^Vo, Hhd, Gs^Edt, Gs, Gd, Gd, Gd, Co, Md, Md, Md, Hhd, Gs^Edt, Gs^Edt, Gs^Edt, Gs, Gs, Gs, Gs, Gd, Gd
Hhd^Qhh, Hhd^Qhh, Gd, Gd, Hh, Gg^Qhux, Hh^Qhux, Hh^Qhux, Mm^Qhux, Hh^Qhux, Mm^Qhux, Mm^Qhux, Mm^Qhux, Mm^Qhux, Hh^Qhux, Hh^Qhux, Hh^Qhux, Hhd, Hh, Gd^Vo, Gs, Gs, Gs, Gd, Md, Mm, Mm, Mm, Hh, Hhd^Edt, Hhd, Gd, Gs, Gg, Cer, Cer, Gs
Hhd, Gd, Gd, Hh, Hh^Qhux, Hh^Qhux, Mm^Qhux, Mm^Qhux, Hh^Qhux, Hh^Qhux, Mm^Qhux, Mm^Qhux, Mm^Qhux, Mm^Qhux, Mm^Qhux, Mm^Qhux, Hh^Qhux, Hh^Qhux, Mm^Qhux, Hh^Qhux, Mm^Qhux, Gs^Edt, Gs, Gs, Gs, Co, Hh^Edt, Mm, Mm, Mm, Mm, Gs, Hh, Hh, Hh, 6 Ker, Cer
Gs, Gs, Hh, Hh^Qhux, Gg^Qhux, Gs^Qhux, Hh^Qhux, Mm^Qhux, Gs^Qhux, Hh^Qhux, Mm^Qhux, Mm^Qhux, Hh^Qhux, Mm^Qhux, Mm^Qhux, Hh^Qhux, Hh^Qhux, Mm^Qhux, Mm^Qhux, Hh^Qhux, Mm^Qhux, Co^Edt, Gs, Gs, Gs, Gs^Edt, Hhd, Hhd^Edt, Mm, Hh, Hhd, Gs, Gs, Hh, Mm, Cer, Gg
Hhd, Hhd, Hh^Qhux, Hh^Qhux, Hh^Qhux, Hh^Qhux, Hh^Qhux, Gs^Qhux, Hh^Qhux, Hh^Qhux, Mm^Qhux, Mm^Qhux, Mm^Qhux, Mm^Qhux, Mm^Qhux, Hh^Qhux, Mm^Qhux, Mm^Qhux, Mm^Qhux, Hh^Qhux, Hh^Qhux, Hh^Qhux, Gs, Gd^Edt, Gd, Gs, Hh, Mm, Mm, Mm, Gs, Hh, Gs, Hh, Hh, Hh, Hh
Hh^Qhux, Hh^Qhux, Hh^Qhux, Hh^Qhux, Mm^Qhux, Mm^Qhux, Gs^Qhux, Gs^Qhux, Gg^Qhux, Hh^Qhux, Gs^Qhux, Hh^Qhux, Mm^Qhux, Mm^Qhux, Gg^Qhux, Hh^Qhux, Gg^Qhux, Mm^Qhux, Gg^Qhux, Gg^Qhux, Gg^Qhux, Mm^Qhux, Mm^Qhux, Gd, Gs, Gs^Edt, Gg, Hh, Hh, Hhd, Gs, Gs, Hh, Gg, Hh, Hh, Hh
Hh^Qhux, Hh^Qhux, Mm^Qhux, Hh^Qhux, Mm^Qhux, Hh^Qhux, Gs^Qhux, Gs^Qhux, Gg^Qhux, Gg^Qhux, Gs^Qhux, Hh^Qhux, Hh^Qhux, Mm^Qhux, Hh^Qhux, Hh^Qhux, Gg^Qhux, Gg^Qhux, Gg^Qhux, Ww^Qhux, Ww^Qhux, Hh^Qhux, Mm^Qhux, Gs, Gs, Gs^Edt, Gg^Edt, Gg, Hh, Hh, Cer, Mm, Hh, Hh, Gg, Mm, Mm
Mm^Qhux, Mm^Qhux, Mm^Qhux, Mm^Qhux, Hh^Qhux, Hh^Qhux, Gs^Qhux, Gg^Qhux, Gg^Qhux, Gs^Qhux, Hh^Qhux, Gs^Qhux, Hh^Qhux, Mm^Qhux, Mm^Qhux, Mm^Qhux, Mm^Qhux, Hh^Qhux, Hh^Qhux, Ww^Qhux, Ww^Qhux, Hh^Qhux, Hh^Qhux, Hh^Qhux, Gs, Gs, Gg, Gg, Gg, Cer, 7 Ker, Hh, Gs, Hh, Gg, Hh, Mm
Mm^Qhux, Mm^Qhux, Gg, Hh^Qhux, Gg^Qhux, Gg^Qhux, Gs^Qhux, Gs^Qhux, Hh^Qhux, Hh^Qhux, Hh^Qhux, Hh^Qhux, Hh^Qhux, Hh^Qhux, Hh^Qhux, Hh^Qhux, Hh^Qhux, Mm^Qhux, Wo^Qhux, Wo^Qhux, Wo^Qhux, Ww^Qhux, Wo^Qhux, Wo^Qhux, Gg, Gg, Gg, Gg, Gs, Cer, Gs, Cer, Gg, Hh, Gg, Gs, Hh
