Hh^Qhh, Ms^Qhh, Ms^Qhh, Ha^Qhh, Ha^Qhh, Gd^Qhh, Hhd^Qhh, Gd^Qhh, Ms, Gd, Hhd, Hhd, Hh, Ms, Ms, Ms, Mm, Hh, Hh, Gd, Hh, Hhd, Hhd, Gd, Gg, Gg, Ss, Rb, Gg, Ss, Sm^Qhu, Sm^Qhu, Ss, Ss, Ss, Ss, Ss, Gg
Ms^Qhh, Hhd, Hh, Ms, Ms, Ms, Ms, Hhd, Hhd, Ms, Ms, Ms, Mm, Hh, Hh, Mm, Hh, Mm, Mm, Ms, Mm, Hhd, Hh, Gs, Gg, Gg, Rb, Rb, Gg, Gg, Aa, Sm^Qhu, Ss, Ss, Sm^Qhu, Sm^Qhu, Sm^Qhu, Ss
Ms^Qhh, Hhd^_mh, Ms, Hhd, Aa, Ms, Ms, Hhd, Hhd, Aa, Gs, Ms, Cer^Edt, Ms, Mm, Gs, Aa, Hh, Aa^Edt, Hh, Aa^Fdw, Mm, Gg, Gs, Gs, Gg, Rb, Aa, Aa, Gg, Aa, Gg, Gg, Ss, Gs, Sm^Qhu, Ss, Sm^Qhu
Hhd^Qhh, Ms, Ms, Ms, Ms, Hhd, Hh, Ms, Ms, Ms, Aa, Cer^Dr, Aa^Edt, Ms, Ms, Rra, Rra, Rra, Rra, Aa^Edt, Aa, Aa^Fdw, Gg, Gg^Fdw, Gd, Rb, Aa, Aa^Esa, Aa, Aa, Ss, Gs, Gs, Gd, Gs, Ss, Ss, Ss
Aa, Aa^Qhh, Hhd^Qhh, Ha^Qhh, Ms^Qhh, Ms^Qhh, Hh^Qhh, Gd, Hh^Qhh, Gs, Aa^Edt, Aa^Edt, Aa^Edt, Ms, Ms, Ms, Aa, Cer, Aa, Rra, Rra, Aa^Fdw, Gg^Fdw, Gd, Re, Re, Gd, Aa, Ss, Aa, Aa, Gs, Gd, Gd, Gg, Sm^Qhu, Sm^Qhu, Ss
Aa, Aa, Gd, Hhd, Aa, Ms, Hhd, Ms^Qhh, Ha^Qhh, Aa, Aa, Aa^Dr, Aa^Dr, Aa, Aa, Aa, Ker, Cer, Aa, Aa, Rra, Aa, Re, Re, Gll^Fmw, Gll^Fmw, Gll^Fdw, Aa, Ss, Ss, Ss, Ss, Gs, Gd, Gd, Gg, Gg, Ss
Aa, Aa, Aa, Aa, Aa, Ha, Ha, Ms, Ha, Ha^Qhh, Ha^Qhh, Aa, Aa^Edt, Aa, Aa, Cer^Edt, Aa^Edt, Aa^Edt, Aa, Aa, Rb, Rra, Gd, Aa, Gd, Gll^Fmw, Gd, Aa, Aa, Aa, Gd, Gd, Gd, Gd, Gs, Gg, Gd, Gg
Aa, Aa, Re, Aa^Esa, Re, Rb, Rra, Aa, Gd, Gd, Aa, Aa^Qhh, Rra^Qhh, Aa, Aa, Aa, Aa, Aa^Vha, Aa, Rb, Gll^Fdw, Gd, Gll^Fdw, Gd, Gd^Fdw, Gll^Fmw, Gll^Fmw, Gd, Gs, Aa, Gs, Gd, Ss, Gd, Gs, Aa, Ss, Gd
Rb, Rb, Aa^Esa, Re, Gs, Aa, Aa, Rra, Rra, Rra, Rra, Rra, Aa, Rra^Qhh, Rb, Aa, Rb, Aa, Rb, Rb, Gd, Gll^Fdw, Gd, Gd, Gd, Gll^Fdw, Gd, Gd, Gd^Fmw, Gs, Gd, Gd, Gd, Gs, Aa, Aa, Aa, Ss
Gd, Aa, Cer^Dr, Aa^Esa, Gs, Aa, Gd, Aa, Aa, Ss, Ss, Aa, Gs, Gd, Gd, Rb, Aa, Rb, Aa, Aa, Gg, Gd, Gg, Gd^Fdw, Gd^Fdw, Gd^Fdw, Gg, Aa, Aa, Aa^Fdw, Aa, Gd, Gd, Gs, Gd, Aa^Edt, Cer, Ss
Gs, Gs, Gs, Gs^Dr, Gd, Gd, Gd, Aa, Ss, Ss, Cer, Gs, Aa, Gd, Aa, Aa, Re, Re, Aa, Aa, Gd, Aa, Aa, Gd, Gg, Gll^Fmw, Gll^Fdw, Gg, Aa, Aa^Fdw, Gd^Fdw, Gd, Gs, Gd^Edt, Gd^Edt, Cer, Gd^Edt, Cer^Edt
Aa, Aa, Aa, Gd, Gd, Gs, Gd, Gd, Gd, Ss, Gd^Edt, Gd, Aa, Aa, Aa, Aa, Rb, Aa, Gd, Gd, Gd, Gd, Gd, Gg, Gd, Gg, Gg^Fdw, Gll^Fmw, Aa, Gd, Gs, Gs, Gs, Cer^Edt, Rb, Gd^Vc, Gs^Ecf, Gd
Ai, Gd, Ai, Ai, Ai, Aa, Aa, Aa, Aa, Gs, Aa, Aa^Esa, Ds^Vhr, Aa, Aa, Aa, Aa, Rb, Gd, Gs, Gd, Gd, Gg, Gd, Gs, Gg, Gg, Gd^Fdw, Gd^Fdw, Gd, Gg, Gs, Cer, Cer, Rb^Edt, Rb, Rb, Rb
Ai, Ai, Wwg, Ai, Ai, Ai, Aa, Aa, Ai, Aa, Ai, Ds, Ds, Aa, Rra, Aa, Rra, Rra, Rra, Gs, Gs, Aa, Aa, Aa, Aa, Gs, Gd, Gg, Gd, Gd, Gd^Edt, Gd^Edt, Cer, Gs^Vc, Re^Ecf, 2 Ket, Re^Vc, Rb
Wog, Ai, Wog, Ai, Ai, Wwg, Wwg, Ai, Wwg, Ai, Ai, Ai, Ai, Ds, Ds, Rra, Aa, Aa, Gd, Rra, Rra, Gs, Aa^Vca, Gs, Aa, Gs, Gd, Aa, Gd, Gd, Aa, Gs^Edt, Gs, Re, Ds^Edt, Re^Edt, Ds, Ds
Ai, Wog, Wog, Wog, Wog, Wog, Wog, Wwg, Wwg, Wwg, Ai, Wwg, Ai, Ai, Ai, Aa, Aa, Gd, Aa, Cer, Aa, Rra, Aa, Aa, Aa, Gg, Gd, Aa, Aa, Aa, Aa, Gs, Rb, Rb, Cer, Ker, Cer^Edt, Cer
Wog, Wog, Wog, Wog, Wog, Wog, Wog, Wog, Wog, Ai, Ai, Ai, Wwg, Ai, Wog, Aa, Aa^Esa, Aa, Aa, Aa, Aa, Aa, Rb, Rb, Re, Aa, Aa, Aa, Aa, Aa, Rra, Aa, Aa, Aa, Aa, Cer, Ds^Edt, Ds
Wog, Wog, Wog, Wog, Wog, Wog, Wog, Wog, Wog, Wog, Wog, Wwg, Wwg, Wwg, Wog, Wog, Ai, Aa, Aa^Esa, Aa, Aa, Aa, Aa, Aa^Edt, Aa, Rra, Rra, Aa, Rra, Rra, Aa, Rra, Rra, Aa, Aa, Aa^Edt, Aa, Aa
Wog, Wog, Wog, Wog, Wog, Wog, Wog, Wog, Ai, Wog, Wog, Wog, Wwg, Wog, Wog, Ai, Ai, Ai, Ai, Aa^Esa, Ai, Aa, Ai, Cer, Gd, Aa, Re, Rra, Aa, Aa, Aa, Aa^Edt, Cer^Edt, Ds, Ds, Ds, Aa, Aa
Wog, Wog, Wog, Wog, Wwg, Wog, Wwg, Wog, Ai, Wog, Wog, Wog, Wog, Wog, Wog, Ai, Wwg, Ai, Ai, Ai, Ai, Ai, Ai, Gs, Gd, Gs, Gs, Aa, Gd, Gd, Gg, Aa, Ds, Ds, Ai, Aa, Ai, Ai
Ai, Wog, Wwg, Ai, Ai, Wwg, Ai, Wwg, Wwg, Ai, Wog, Wog, Wog, Wog, Wog, Wwg, Ai, Wwg, Wwg, Ai, Ai, Ai, Ai, Ai, Ai, Gs, Ai, Ai, Ai, Ai, Ai, Aa, Aa, Ai, Ai, Ai, Ai, Ai
Ai, Ai, Ai, Ai, Ai, Ai, Ds, Ai, Ai, Wog, Ai, Wog, Wog, Wog, Wog, Wog, Wog, Wog, Wog, Ai, Wwg, Ai, Ai, Ai, Wog, Ai, Ai, Ai, Wog, Wwg, Wog, Ai, Wwg, Wwg, Wwg, Ai, Wwg, Wwg
Aa, Ai, Aa, Ai, Ds, Ds, Aa, Ai, Ai, Ai, Ai, Wog, Wwg, Wog, Wog, Wog, Wog, Wog, Wog, Wog, Wwg, Ai, Wog, Wog, Wog, Wog, Wog, Wog, Wog, Wog, Wog, Wog, Wog, Wog, Wog, Wog, Wog, Wog
Aa, Aa, Gd, Aa, Aa, Aa^Esa, Aa, Aa, Gd^Ecf, Ai, Cea, Ai, Ai, Wwg, Wog, Wog, Wog, Wog, Wog, Wog, Wog, Wog, Wog, Wog, Wog, Wog, Wog, Wog, Wog, Wog, Wog, Wog, Wog, Wog, Wog, Wog, Wog, Wog
Aa, Aa^Vla, Aa, Gd, Gll^Fmw, Gll^Fdw, Gs^Fdw, Aa, Cea, Kea, Cea, Ai, Ai, Wwg, Wwg, Wwg, Wwg, Wog, Wog, Wog, Wog, Wog, Wog, Wog, Wog, Wog, Wog, Wog, Ai, Wog, Wog, Wog, Wog, Wog, Wog, Wog, Wog, Wog
Aa^Qhhf, Aa^Qhhf, Aa, Aa, Aa, Aa, Aa, Aa, Aa, Aa^Fdw, Aa, Ai, Ai, Ai, Ai, Wwg, Wwg, Wog, Wog, Wog, Wog, Wog, Wog, Wog, Wog, Wog, Ai, Ai, Wog, Wog, Wog, Wog, Wog, Wog, Wog, Wog, Wog, Wog
Gd^Qhh, Aa^Qhh, Aa^Qhh, Gd^Qhh, Aa^Qhh, Aa, Gll^Qhhf, Aa, Aa, Aa, Aa^Vha, Aa, Ai, Ai, Ai, Ai, Wog, Wog, Wwg, Wog, Wwg, Wog, Wog, Wog, Wog, Wog, Wog, Ai, Wog, Wog, Wog, Wog, Wog, Wog, Wog, Wog, Wog, Wog
Aa^Qhh, Aa^Qhh, Gll^Qhhf, Aa^Qhh, Aa^Qhh, Gll^Qhhf, Gs^Qhhf, Gll^Qhhf, Aa, Aa^Fdw, Aa, Aa^Fdw, Aa, Ai, Ai, Ai, Ai, Ai, Ai, Wwg, Ds, Wwg, Ai, Wog, Wog, Wog, Wog, Wog, Wog, Wog, Wog, Wog, Wog, Wog, Wog, Wog, Wog, Wog
Gll^Qhhf, Gll^Qhhf, Gll^Qhhf, Gll^Qhhf, Aa^Qhh, Gd^Qhh, Gs^Qhh, Gll^Qhhf, Gll^Qhhf, Aa, Aa^Fdw, Gd^Fdw, Aa, Ai, Aa^Fdw, Ai, Aa, Ai, Aa, Ai, Aa, Ai, Ai, Ai, Wog, Wog, Wog, Wog, Wog, Wog, Ai, Wog, Ai, Ai, Ai, Ai, Ai, Ai
