Ms, Ss, Hh, Aa, Aa^Esa, Hh, Hh, Mm, Ms, Ss, Ha, Ss, Hh, Ss, Gg^Fdw, Hh, Ms, Ss^Fdw, Hh^Fdw, Ss, Ss^Edt, Ss^Edt, Ss^Edt, Sm^Qhux, Sm^Qhux, Sm^Qhux, Sm^Qhux, Sm^Qhux, Sm^Qhux, Ww, Ww, Ww, Ww, Ww, Ss, Ss, Ww, Ww, Ww, Ww, Ww, Ww, Ww, Wwf, Wwf, Ss, Ss, Ww, Ww, Ss, Wwf, Ss
Hh^Fdw, Ms, Mm, Gg, Aa^Esa, Aa^Esa, Ai, Hh, Ha, Ms, Cha, Ha, Gg, Hh, Ha^Fma, Gg^Fdw, Aa^Fma, Ha^Fma, Aa, Gs, Chr, Ss^Edt, Chr^Dr, Ss, Ss, Sm^Qhux, Sm^Qhux, Sm^Qhux, Sm^Qhux, Ss, Ww, Ss, Ww, Ss, Ss, Ss, Ss, Ss, Ss, Ww, Ww, Ww, Ww, Ww, Ww, Ss, Ww, Ss, Ww, Ww, Wwf, Wwf
Ha^Fdw, Mm, Gg, Ss, Ai, Ai, Gg, Ss, Ss, Gs, Chr^Es, Ss, Ss, Gg, Aa, Ha^Es, Gs, Gs^Fdw, Chr^Edt, Rr, Rp, Chr, Chr^Dr, Chr^Edt, Ss^Edt, Ss, Sm^Qhux, Sm^Qhux, Ss, Ss, Ww, Ww, Ss, Ss, Ss, Ss, Ww, Ss, Ww, Ww, Ww, Ww, Ww, Ww, Ww, Ww, Ww, Ww, Ss, Ww, Ww, Wwf
Aa^Fma, Hh^Fdw, Gs^Fdw, Gg^Fdw, Gg^Es, Ai, Ss, Gg, Chr, Chr^Dr, Chr^Dr, Ss, Ss, Hh, Aa^Esa, Hh^Fdw, Ss, Chr, Ss, Ss^Edt, Ss, Ss^Dr, Chr^Edt, Chr, Ss, Ss, Sm^Qhux, Sm^Qhux, Ss, Ss, Ww, Ss, Ss, Ss, Ss, Ss, Ww, Ww, Ss, Ww, Ww, Ww, Ww, Ww, Ww, Ww, Ww, Ww, Ww, Ss, Ss, Wwf
Aa, Aa^Fdw, Aa, Aa^Esa, Ss, Ss^Edt, Ss^Edt, Ss^Edt, Ss^Edt, Chr^Edt, Rp, Ss, Gg, Gg^Fdw, Gg^Fdw, Gg, Ss, Hh, Hh, Ss^Edt, Ss, Ss, Ss, Ss, Ss, Sm^Qhux, Sm^Qhux, Ss, Ss, Wwf, Ww, Ss, Ss, Ss, Wwf, Ww, Ww, Ww, Ss, Ss, Ww, Wwf, Ww, Ww, Chr, Ww, Wwf, Ww, Ww, Ss, Ss, Ss
Gg, Gs, Ss, Ha, Gg, Ss, Gg, Ss^Edt, Ss^Edt, Ss^Edt, Ss, Ss^Bw\r, Ss, Gg^Fdw, Gg, Gg, Gs, Ss, Rp, Ss, Ss, Ss, Gd^Fdw, Gs^Fdw, Gs, Ss, Ss, Ss, Ss, Ww, Ww, Ss, Ss, Ww, Ss, Ww, Ww, Ww, Ww, Ww, Wwf^Edt, Chr^Edt, Chr^Edt, Ss, Ss, Wwf, Wwf, Ww, Chw, Ww, Ss, Ss
Ss, Gs, Aa, Hh, Gg, Ss, Hh, Rp, Rp, Ss^Edt, Ss, Ss^Bw|r, Ss, Ss, Ss^Em, Ss, Tb^Tf, Rp, Hh^Fdw, Rp, Gd, Ss, Hhd, Gd^Fdw, Gd^Fdw, Ss, Ss, Ss^Edt, Ss, Cer, Ww, Ss, Ww, Ww, Ss, Gd, Gs, Ss, Ss, Wwf, Chr, Chr^Dr, Ss, Chw, Ss^Bw\r, Ss, Ss^Bw/r, Chr^Edt, Chr^Dr, Chw, Ww, Ww
Ss, Gs, Gs, Aa, Gs^Fdw, Hh^Fdw, Hh^Es, Ss, Gs, Ss^Edt, Ss, Ss, Ss^Em, Ss^Em, Ss^Em, Ss^Tf, Ss^Tf, Gg, Gs^Fdw, Gs^Fdw, Cer, Gd, Hh, Hhd^Fdw, Ss, Gs^Fdw, Ss^Edt, Cer^Edt, Cer, Cer, Cer, Ww, Ss, Ss, Sm^Qhux, Sm^Qhux, Sm^Qhux, Sm^Qhux, Ss^Qhux, Ss, Ss, Ss, Ss^Edt, Ss, Ss, Ss^Bw|r, Ss, Ss, Chr, Ss^Dr, Ss^Edt, Ww
Ss, Ss, Ss, Gs, Gs^Fdw, Gs^Fdw, Ss^Edt, Ss, Gs^Efm, Gg^Efm, Rp, Chr^Es, Ss^Dr, Ss, Ss, Ss^Em, Ss, Cer, Cer^Edt, Cer^Edt, Cer, Gd, Ss, Gs, Rp, Ss, Ss^Edt, Ss, Ss^Edt, Cer^Edt, Ww, Ww, Ss, Sm^Qhux, Sm^Qhux, Sm^Qhux, Ss^Tf, Sm^Qhux, Sm^Qhux, Sm^Qhux, Sm^Qhux, Ss^Edt, Dd, Chr^Edt, Chr^Dr, Chr, Ss^Dr, Ss, Ss^Bw|r, Ss, Ss, Ss
Ss, Ss, Ss^Edt, Ss, Gs^Fdw, Ss, Gg, Rr^Dr, Rr, Rp, Chr^Edt, Chr^Edt, Chr^Dr, Chr^Edt, Ss^Edt, Ss, Ss, Ss^Edt, Ss^Edt, Ss^Edt, Ss, Ss, Ss, Gd^Vhr, Ss, Rp, Ss^Bw\, Ss, Ss, Ww, Ds, Ss, Sm^Qhux, Sm^Qhux, Sm^Qhux, Ss^Tf, Ss^Emf, Ss^Emf, Ss^Tf, Sm^Qhux, Ss, Ss, Dd, Dd^Edt, Chr, Chr^Edt, Chr, Ss, Ss^Bw\r, Ss, Ss, Ss
Gg, Gs^Edt, Ss, Ss, Rp, Ss, Gs, Rp, Rp, Gs, Gs^Fdw, Gg^Fdw, Ss^Bw|, Chr^Edt, Ss, Ss, Sm^Qhux, Ss, Ss, Ss, Ss^Em, Ss^Em, Ss, Ss, Ss^Edt, Ss, Ss^Bw/r, Ss^Bw\r, Ww^Bw\, Ww, Ds, Ss, Sm^Qhux, Sm^Qhux, Ss, Sm^Qhux, Sm^Qhux, Sm^Qhux, Sm^Qhux, Sm^Qhux, Ss, Dd, Ss, Dd, Ds, Ds, Chr^Edt, Ss^Bw/, Ss, Ss^Bw\r, Cer, Cer^Edt
Gg^Efm, Gg, Gg^Efm, Ss, Rr^Dr, Rp, Ss, Gs, Rp^Vhcr, Ss, Ss^Bw|r, Ss^Bw/r, Ss^Edt, Ss, Ss, Sm^Qhux, Sm^Qhux, Sm^Qhux, Ss, Ss, Ss, Ss^Emf, Ss^Edt, Ss^Edt, Ss^Edt, Ss^Bw/r, Ss, Ss, Ww, Ds^Bw\, Ss^Bw/r, Ss, Ss, Ss, Dd, Ss, Ss, Sm^Qhux, Ss, Ss, Ds, Cer, Cer, Ds, Ds, Ds, Ss^Edt, Ss, Ss, Ss, Ss^Bw|r, Cer^Edt
Gg, Gs^Efm, Aa, Gd^Efm, Ss^Tf, Gg, Gg, Ss, Rr, Ai, Ss^Bw|, Ss, Ss, Ss^Edt, Sm^Qhux, Sm^Qhux, Ss, Ss, Ss, Chr, Tb^Tf, Ss, Ss, Ss^Edt, Ss, Ss, Ss, Ss, Ss, Ww, Ww, Ss, Ss, Dd, Ds, Dd, Ds, Ss, Cer, Ds, Dd^Edt, Dd^Vdr, Ds, Ss, Ss, Ss^Edt, Ss^Edt, Ss^Edt, Ss^Edt, Ss, Cer^Edt, Ss
Ai, Ai, Ai, Ss^Em, Ss, Tb^Tf, Tb^Tf, Rr, Gs, Aa, Ai^Bw/r, Ss, Sm^Qhux, Sm^Qhux, Sm^Qhux, Sm^Qhux, Ss, Ss^Dr, Chr^Dr, Chr, Tb^Tf, Tb^Tf, Ss^Tf, Ss^Em, Ss^Emf, Wwf, Wwf, Wwf, Ww, Ww, Ss^Em, Ss, Dd, Dd, Ds, Dd, Ds, Ss, Cer, Dd, Cer^Edt, Dd^Edt, Ss, Ss, Ss, Ss, Sm^Qhux, Sm^Qhux, Ss, Cer, Ss, Cer^Edt
Gg, Ss, Gd^Efm, Aa, Ss, Tb^Tf, Ss^Tf, Chr, Chr^Es, Cha, Ss^Edt, Ss, Sm^Qhux, Sm^Qhux, Ss, Ss, Ss, Ss, Chw, Chw, Ww, Ss^Em, Ss^Tf, Ss^Tf, Ss, Ww, Ww, Ww, Ds, Ww, Ww, Ss^Em, Wwf, Ds, Ss, Ds, Ss, Ss^Em, Ss^Emf, Cer, Cer, Cer, Ss, Ss, Ss, Sm^Qhux, Sm^Qhux, Sm^Qhux, Sm^Qhux, Ss, Ss, Ss
Ss, Gg, Gd, Gd^Efm, Gs, Ss^Em, Ss^Em, Ss^Em, Chr, Chr^Edt, Ss^Bw\r, Ss, Ss, Sm^Qhux, Ss, Wwf, Wwf, Wwf, Ww, Wwf, Wwf, Ss^Em, Ss, Ss^Em, Ss, Ww, Ss, Ds, Ker, Ds, Cer, Ww, Ds, Wwf, Wwf, Ss, Ss, Ss^Em, Ss, Ss^Tf, Ss^Em, Ss, Ss, Ss, Ds^Edt, Ss, Ss, Sm^Qhux, Sm^Qhux, Sm^Qhux, Ss, Ss
Gg, Gs, Ss, Gg^Efm, Gs, Ss, Ss, Ss^Edt, Ss, Ss, Ss, Ss^Bw\, Ss^Bw|r, Ss, Ww, Wwf, Ww, Ww, Wwf, Wwf, Ss, Ww, Ww, Ss, Ww, Ww, Ss, Cer, Rb, Cer, Cer, Ss^Emf, Ss^Tf, Ss^Em, Ww, Ww, Ss, Ss, Ss, Ss, Ss, Ds, Dd^Esd, Dd, Dd, Ds, Ss, Sm^Qhux, Sm^Qhux, Ss, Dd, Ww
Gd^Efm, Gs^Efm, Gs, Ss, Ss, Gd, Ss, Sm^Qhux, Sm^Qhux, Sm^Qhux, Sm^Qhux, Ss, Ss^Bw\r, Wwf, Wwf, Ww, Ww, Wwf, Ww, Wwf, Ww, Ww, Ww, Ww, Ss, Ss, Rb, Ss, Rb, Cer, Ds, Tb^Tf, Ds, Ss^Em, Ds, Ww, Ww, Ww, Ww, Ss^Em, Ss, Ds, Ds^Esd, Ds, Dd^Do, Dd, Ss, Sm^Qhux, Ss, Ss, Ss, Dd
Ss, Gs, Ss, Ss, Ss, Ss, Sm^Qhux, Sm^Qhux, Sm^Qhux, Sm^Qhux, Ss, Ss, Chr, Chr, Wwf, Wwf, Ww, Ww, Ww, Ww, Ss^Em, Ss, Rb, Ss, Ss, Rb, Ss, Rb, Ss^Em, Ss^Em, Ds, Ds^Esd, Ds^Esd, Ss^Em, Ds, Ds^Esd, Ds^Esd, Ds^Esd, Ds, Ww, Wwf, Ds, Ds, Ds^Esd, Wwf, Wwf, Chr^Edt, Ss^Edt, Ss, Ds, Ds^Esd, Ds
Ai, Ss, Sm^Qhux, Sm^Qhux, Sm^Qhux, Sm^Qhux, Sm^Qhux, Sm^Qhux, Sm^Qhux, Sm^Qhux, Ss, Chr, Chw, Wwf, Wwf, Ww, Ds, Ww, Wwf, Ss^Em, Ss, Ss, Ss, Rb, Re, Ss, Ss, Ss, Sm^Qhux, Ss^Em, Ss, Ds, Ds^Esd, Ds, Ss, Ds, Ss, Ss, Ds, Ds, Ss, Wwf, Wwf, Ss, Ww, Chw, Chw, Chr^Edt, Chw, Ww, Dd, Ds^Esd
Ai, Ss, Ss, Sm^Qhux, Ss, Ss, Ss, Ss, Ss, Ss, Ss, Chw, Ww, Ss, Ww, Ww, Ww, Ww, Wwf, Ss, Ss, Ss, Re, Re, Re, Ss^Vhs, Ss, Sm^Qhux, Sm^Qhux, Sm^Qhux, Ss, Ds, Ds, Ds, Ss, Ds, Ds, Ss, Cer, Ss, Ds, Ds, Ss, Ww, Ww, Ww^Dr, Ss, Ss, Ww, Ww, Ww, Ww
Aa^Esa, Ss, Wwf, Ss, Wwf, Ss, Ds, Ds, Ww, Ww, Ww, Ww, Ww, Ww, Ww, Ww, Ss, Ss, Ss, Ss, Ss, Rb, Ss^Emf, Rb, Ss, Ss, Sm^Qhux, Sm^Qhux, Sm^Qhux, Ss, Ss, Ds, Ds, Dd, Dd, Dd, Dd, Cer, Cer, Ss^Vhs, Ss, Ds, Ss, Ss, Chw, Ww, Wwf, Wwf, Wwf, Ss, Ds, Ww
Ss, Ss, Wwf, Ww, Ww, Ww, Ww, Ww, Ww, Ww, Ds, Wwf, Wwf, Wwf, Ss, Ss, Sm^Qhux, Sm^Qhux, Ss, Ss, Rb, Rb, Ss^Em, Ss^Em, Ss, Sm^Qhux, Ss, Ss, Ss, Ss, Ss, Ds, Ds, Ds, Dd, Dd, Dd, Ds, Cer^Edt, Cer^Edt, Ds^Esd, Ss, Ds, Ds, Ss^Dr, Chw^Dr, Chr, Chr, Ds, Ds, Ds, Ds
Ss, Wwf, Ww, Ww, Ss, Ww, Ww, Ww, Ss, Ds, Ds, Ss, Ss, Ss, Ss, Sm^Qhux, Sm^Qhux, Ss, Rb, Ss, Rb, Rb, Ss, Ss, Ss, Ss, Ss, Ds, Ds, Ss, Ss, Ss, Ss, Ss, Ds^Esd, Ds^Esd, Ds, Ds, Ds^Edt, Ds^Esd, Ds^Esd, Ds, Ds, Dd^Edt, Dd^Edt, Chr^Edt, Ss, Ds, Ds, Ds, Ss, Ds
Ss, Ss, Ww, Ww, Ww, Ww, Ds, Ss, Ss, Ss, Ss, Ss, Ai, Ss, Sm^Qhux, Sm^Qhux, Ss^Em, Ss^Em, Re, Re, Ss, Ss, Sm^Qhux, Sm^Qhux, Ss, Ss, Ds, Ss, Dd^Esd, Ds, Ds^Esd, Ss, Ss, Ss, Ds, Dd^Do, Cer, Ds, Cer, Ds, Ds, Ds, Ds^Esd, Dd, Dd, Dd, Dd, Ss, Ss^Edt, Ds^Esd, Ds^Esd, Ds^Esd
Ww, Ww, Ss, Ss, Ss, Ww, Ds, Ds, Ai, Ai, Ai, Ai, Ss, Ss, Sm^Qhux, Sm^Qhux, Ss^Em, Re, Rb, Re, Ss, Ss, Sm^Qhux, Sm^Qhux, Ss^Em, Ds, Ds, Dd, Dd, Ds^Esd, Dd^Esd, Dd, Ss, Ss, Ss, Ds^Esd, Cer^Edt, Cer^Edt, Rrd^Edt, Cer^Edt, Ds, Ds^Esd, Ds^Esd, Dd^Do, Ss, Dd, Dd, Ss, Ss, Ds, Ds, Dd
Ww, Ww, Ai, Ss, Ww, Ww, Ds, Ai, Aa, Aa^Esa, Aa^Esa, Ss, Ss, Sm^Qhux, Ss, Ss^Em, Rb, Rb, Ss, Ss, Ss, Sm^Qhux, Sm^Qhux, Sm^Qhux, Sm^Qhux, Ss^Em, Ss, Ss, Ss, Dd, Dd^Esd, Dd^Esd, Dd, Ss, Ss, Ss, Ss, Cer, Rrd, Rrd, Rrd, Rrd, Rrd, Ds^Esd, Dd, Ss, Dd^Esd, Dd, Dd, Dd^Esd, Ds^Esd, Dd
Ds, Ww, Ai, Ai, Ww, Ww, Ds, Ds, Aa, Ai, Aa, Ai, Aa, Ss, Aa^Esa, Aa, Rb, Aa^Esa, Ai, Ss, Ss, Ss, Sm^Qhux, Sm^Qhux, Sm^Qhux, Ss, Ss, Ss, Ss, Dd, Dd, Dd^Esd, Ds, Ds, Ss, Ss, Ss, Ds, Ds, Ds, Rrd, Rrd, Rrd, Rrd, Ds, Ss, Ss, Dd^Esd, Dd, Dd^Esd, Dd, Dd^Esd
