Ai, Wog, Ha^Qhh, Ms^Qhh, Ms^Qhh, Chr^Qhh, Ha^Qhh, Aa, Aa^Vka, Aa, Aa, Re, Aa, Aa, Ha^Fda, Ha^Qhhf, Ms^Qhh, Ms^Qhh, Ms^Qhh, Ms^Xm, Ms^Xm, Ha^Qhh, Ha^Qhh, Ai^Qhh, Ai^Qhh, Ai^Qhh, Ai^Qhh, Ai^Qhh
Aa, Wog, Wog, Ha^Qhh, Ha, Ha, Ha, Ha^Qhh, Ha^Qhh, Ss, Ss, Aa, Re, Aa, Aa, Ha^Fdw, Ha, Ms, Ms, Ms^Qhh, Ms^Qhh, Ms^Xm, Ms, Ha^Qhh, Ha^Qhh, Ai^Qhh, Ai^Qhh, Ai^Qhh
Ms, Ai, Ai, Ai, Aa^Qhh, Ha, Ms, Ms, Ha^Qhh, Ss, Ai, Aa, Re, Rb, Aa, Ha, Aa, Ha, Aa, Ms^Qhh, Ms, Ms^Xm, Ms^Xm, Ha^Qhh, Ha^Qhh, Ha^Qhh, Ha^Qhh, Ha^Qhh
Ms, Ha, Aa, Wog, Wog^Qhh, Ha, Ha^Qhh, Ms^Qhh, Ha^Qhh, Ha^Qhh, Ha, Ai, Ai, Re, Re, Aa, Aa, Ha, Aa, Ha^Qhh, Ms^Qhh, Ms^Qhh, Ms^Xm, Ms, Ms^Xm, Ha^Qhh, Ms, Ha^Qhh
Ms, Ha, Ha, Ai, Ss, Wog, Aa, Ha, Ha^_mh, Aa^Qhh, Aa^Qhh, Ai, Aa, Aa, Aa, Aa, Re, Aa, Aa, Ha, Ha^Qhh, Ms^Qhh, Ms^Xm, Ms^Xm, Ms^Xm, Ms, Ms, Ms^Xm
Ms, Ms, Ms, Ss, Ss, Wog^Qhh, Wog, Aa^Qhh, Ha^Qhh, Ha^Qhh, Ha^Qhh, Aa^Qhh, Aa^Qhh, Aa, Aa, Aa, Aa, Rb, Aa, Aa, Ha, Ha^Qhh, Ms^Xm, Ms^Xm, Ms^Xm, Ms^Xm, Ms^Xm, Ms^Xm
Ms, Ms, Ms, Ha, Ai, Ai, Wog, Ha^Qhh, Ha^Qhh, Aa^Qhh, Aa^Qhh, Aa^Qhh, Aa^Qhh, Aa, Aa, Ss, Ss, Aa, Aa, Aa, Aa^Dr, Ha^Qhh, Ha^Qhh, Ha^_mh, Ha^Qhh, Ms^Xm, Ha^Qhh, Ms^Xm
Ms, Ms, Ha, Ha, Ai, Wog, Wog^Qhh, Ha^Qhh, Wog, Aa^Qhh, Ai, Aa^Qhh, Ai, Ss, Ss, Ss, Re, Re, Aa, Aa, Aa^Esa, Aa, Ha, Ha^Qhh, Ha^Qhh, Ha^Qhh, Ha^Qhh, Ha^Qhh
Ms, Ha, Ai, Ai, Ha^Qhh, Wwg, Wwg^Qhh, Wog, Wog, Wog, Ai, Ai, Ai, Ss, Aa, Ss, Re, Aa, Gs, Aa^Esa, Aa^Esa, Aa, Aa, Ha, Ha, Ha, Ha, Ha^Qhh
Wog, Wog, Ss, Ss, Ss, Wwg, Wwg^Qhh, Wog, Aa, Ai, Gd, Aa, Aa, Ai, Aa, Aa, Aa, Aa^Esa, Gs, Gd, Ss, Aa^Dr, Ss, Ha, Ha, Aa, Aa^Esa, Ha
Ha, Ha, Dd, Ds, Ds, Dd, Gs^Qhh, Dd^Esd, Gd, Aa, Gd, Aa, Gd, Aa, Aa, Aa, Re, Gd, Aa^Dr, Gs, Gs, Ss, Ss, Ai, Aa, Aa, Aa, Ha
Ds^Esd, Dd, Ds^Esd, Ds, Ss, Ss, Gs^Qhh, Aa, Gd, Re, Ss, Gs, Gs, Rb, Rb, Rb, Ai, Ss, Ss, Aa, Aa, Aa, Ai, Ss, Aa, Aa, Ss, Aa
Dd, Dd, Dd, Ds, Dd, Ss, Dd, Re, Gg, Ss, Sm^Qhux, Gs, Ss, Gs, Gs, Ss, Sm^Qhux, Ai, Sm^Qhux, Aa, Sm^Qhux, Ss, Ai, Ai, Aa, Aa, Ai, Ss
Gd, Gd, Ds, Dd, Ds, Dd^Esd, Dd^Do, Rb, Gg, Sm^Qhux, Sm^Qhux, Sm^Qhux, Ss, Sm^Qhux, Sm^Qhux, Sm^Qhux, Sm^Qhux, Sm^Qhux, Sm^Qhux, Sm^Qhux, Sm^Qhux, Sm^Qhux, Ss, Ss, Ss, Ss, Ai, Ai
Gs, Gs, Gd, Ds, Ss, Ds, Ai, Dd^Esd, Gg, Ss, Sm^Qhux, Sm^Qhux, Sm^Qhux, Ai, Ai, Sm^Qhux, Sm^Qhux, Sm^Qhux, Sm^Qhux, Sm^Qhux, Sm^Qhux, Sm^Qhux, Sm^Qhux, Ai, Aa, Ss, Ai, Ss
Ds, Ds, Gs^Efm, Gd^Efm, Gs^Efm, Ss, Aa, Gg, Rb, Ss, Ss, Ss, Ss, Ai, Ss, Ai, Ss, Sm^Qhux, Ss, Ss, Ss, Sm^Qhux, Ss, Ai, Gd^Fmw, Gd^Fmw, Ss, Ai
Dd, Dd, Ds, Aa, Ai, Aa, Aa, Gg, Gg, Rb, Gs, Gs, Re, Rb, Re, Ss, Ss, Gs, Ss, Ss, Ss, Gs^Fdw, Gg^Fmw, Gg, Gs^Fdw, Gs^Fmw, Aa, Ss
Ds^Esd, Ds^Esd, Aa, Aa, Aa, Ai, Ss, Ss, Ss, Ss, Ss, Gg, Gs, Gs, Dd, Rb, Gg, Gs, Gs, Ss, Ss, Ss, Ss, Gg^Fmw, Gg^Efm, Gs^Fmw, Gg^Fdw, Aa
Ds^Esd, Ds^Esd, Sm^Qhux, Sm^Qhux, Sm^Qhux, Aa, Sm^Qhux, Gg, Ss, Ss, Ss, Ss, Ss, Gg, Dd, Dd, Dd, Gs, Rb, Re, Rb, Gg, Gs, Gs^Efm, Gs^Fdw, Ss, Ss, Gs
Sm^Qhux, Sm^Qhux, Sm^Qhux, Sm^Qhux, Sm^Qhux, Sm^Qhux, Sm^Qhux, Sm^Qhux, Gd, Ss, Gg, Ss, Gg, Gs, Gd, Gd, Gd, Gs, Ss, Gs, Ss, Rb, Rb, Gs, Re, Gs^Fdw, Ss, Ss
Sm^Qhux, Sm^Qhux, Sm^Qhux, Sm^Qhux, Sm^Qhux, Ss, Ss, Sm^Qhux, Sm^Qhux, Sm^Qhux, Gd, Gs, Gg, Ss, Ss, Ss, Ss, Ss, Gg, Ss, Gs, Gs, Sm^Qhux, Rb, Ss, Gs, Re, Ss
Sm^Qhux, Sm^Qhux, Sm^Qhux, Sm^Qhux, Sm^Qhux, Ss, Ss, Sm^Qhux, Ss, Sm^Qhux, Sm^Qhux, Gd, Gg, Ss, Gg, Gg, Gg, Gg, Gg, Gg, Gg, Sm^Qhux, Sm^Qhux, Sm^Qhux, Sm^Qhux, Ss, Ss, Re
