Ms, Ms, Ai, Wog, Wog, Ms, Ms, Ms, Ms, Ms, Ms^Xm, Ms^Xm, Ms^Xm, Ms^Xm, Ms^Qhh, Ms^Qhh, Ms^Qhh, Ms^Qhh, Ms^Qhh, Ms^Qhh, Ms^Qhh, Ms^Qhh, Ms^Qhh, Ms^Qhh, Ms^Qhh, Ms^Qhh, Ms^Qhh, Ms^Qhh, Ms^Qhh, Ms^Qhh, Ms^Qhh, Ms^Qhh, Ms^Qhh, Ms^Qhh, Ms^Qhh, Ms^Qhh
Ai, Ms, Wog, Ai, Ms, Ms, Ms, Ms, Ms, Ms^Xm, Ms, Ms^Xm, Ms^Xm, Ms^Xm, Ms^Xm, Ms^Qhh, Ms^Qhh, Ms^Qhh, Ms^Qhh, Ms, Ms, Ms^Xm, Ms, Ms^Xm, Ms, Ms, Ms, Ms, Ms, Ms^Xm, Ms^Xm, Ms^Xm, Ms^Xm, Ms, Ms^Xm, Ms^Qhh
Ai, Ai, Wog, Wog, Ai, Ms, Ai, Ai, Ai, Ms, Ms, Ms^Xm, Ms^Xm, Ms^Xm, Ms^Xm, Ms^Xm, Ms, Ms^Qhh, Ms, Ms^Qhh, Ms^Qhh, Ms, Ms^Qhh, Ms^Qhh, Ms^Qhh, Ms, Ms, Ms, Ms, Ms, Ms^_mhh, Ms^Xm, Ms^Xm, Ms, Ms, Ms^Qhh
Ai, Ai, Ms, Ms, Ms, Ai, Ms^Xm, Ms, Ms^Xm, Ms, Ms^Xm, Ms^Xm, Ms^Xm, Ms^Xm, Ms^Xm, Ms^Xm, Ms, Ms, Ha, Ha^Fda, Aa, Ms^Qhh, Ha^Qhh, Ha^Qhh, Aa^Qhh, Ms^Qhh, Ms^Qhh, Ms^Qhh, Ms^Qhh, Ms, Ms, Ms, Ms^Xm, Ms^Xm, Ms^Xm, Ms^Qhh
Ai, Ms, Ms, Ms^Xm, Ms^Xm, Ms^Xm, Ms^Xm, Ms^Xm, Ms^Xm, Ms^Xm, Ms, Ms, Ms^Xm, Ms^Xm, Ms^Xm, Ms^Xm, Ms, Ms, Ha^Fdw, Aa^Fda, Aa^Fda, Ha, Ha, Aa^Fdw, Aa, Ha^Qhh, Ha^Fda, Ha^Qhh, Aa^Qhh, Ms, Ms, Ms, Ms^Xm, Ms^Xm, Ms^Xm, Ms^Qhh
Ai, Ai, Ms, Ms, Ms^Xm, Ms, Ms, Ms, Ms, Ms, Ms, Ms, Ms, Ms^Xm, Ms^Xm, Ms, Ms, Ms, Ms, Aa, Aa, Ha, Aa, Re, Aa, Aa^Fda, Aa, Aa, Aa^Fda, Ms^Qhh, Ms^Qhh, Ms, Ms, Ms^Xm, Ms, Ms^Qhh
Ms, Ms^Xm, Ms^Xm, Ms^Xm, Ms, Ms, Ms, Ms, Ha, Ms, Ms, Ms, Ms, Ms, Ms^Xm, Ms, Ms, Ms, Ms, Ha^Fdw, Ha, Re, Re, Rb, Ha^Fda, Ha, Ha^Vka, Aa^Fda, Aa^Fdw, Ha^Qhh, Ms^Qhh, Ms, Ms, Ms, Ms^Qhh, Ms^Qhh
Ms^Xm, Ms^Xm, Ms^Xm, Ms, Ms, Ms, Ha, Ha, Aa, Aa, Ha, Ms, Ms^Xm, Ms^Xm, Ms^Xm, Ms, Aa, Aa, Aa, Ha, Aa, Re, Rb, Aa^Fda, Ha^Vka, Ms, Ms, Ha^Fdw, Ha^Fdw, Ha^Qhh, Ha^Qhh, Ms, Ms^Qhh, Ms^Qhh, Ha^Qhh, Ms
Ms^Xm, Ms^Xm, Ms^Xm, Ms, Ms, Ms, Ha, Ha, Aa, Aa, Ha, Ms, Ms, Ms^Xm, Ms, Ms, Ha, Aa, Aa, Ha, Aa, Aa^Fda, Aa^Fdw, Ha^Fdw, Aa, Chr, Cha^Kov, Cha, Ms, Ha, Aa^Fdw, Aa^Qhhf, Aa^Fda, Ha^Qhh, Aa^Fda, Ha^Fdw
Ms^Qhux, Ms^Qhux, Ms^Qhux, Ms^Xm, Ha^Qhux, Aa, Aa, Aa, Aa, Ha, Ha, Ha, Cha, Ms, Cha^Kov, Cha, Ha, Aa, Rb, Aa, Aa, Aa, Re, Aa, Aa, Cha, Ha, Ms, Ha, Ms, Ha^Qhh, Ha^Qhh, Aa^Qhhf, Aa, Aa, Aa^Fda
Ms^Qhux, Ms^Xm, Ms^Qhux, Ms^Qhux, Ha^Qhux, Aa, Aa, Re, Aa, Ha, Aa, Ha, Aa, Chr, Ha, Chr, Rb, Rb, Aa, Aa, Aa, Aa, Rb, Rb, Aa, Aa, Aa, Aa^Vka, Aa, Aa, Ha^Qhh, Aa^Qhhf, Aa^Qhhf, Aa^Qhhf, Ha^Fdw, Aa^Qhhf
Ha^Qhux, Ms^Qhux, Ms^Qhux, Ms^Qhux, Ha^Qhux, Ha^Qhux, Aa, Rb^Vhr, Rb, Aa, Aa, Aa, Re, Aa, Aa, Aa, Aa, Rb, Aa, Rb, Re, Rb, Aa, Aa, Aa, Aa, Aa, Aa, Ha, Aa^Qhh, Ms^Qhh, Aa^Qhh, Ha^Fdw, Ha^Fda, Ms, Aa^Qhhf
Ha^Qhux, Ha^Qhux, Ha^Qhux, Ha^Qhux, Ha^Qhux, Aa, Re, Aa, Re^Vhr, Rb, Aa, Re, Aa, Aa, Aa, Aa, Ha^Qhh, Aa, Aa, Aa, Aa, Re, Aa, Aa, Aa^Fdw, Aa^Qhhf, Ha^Qhhf, Ha^Qhh, Ha^Qhh, Ms^Qhh, Ms, Ms, Ms^Xm, Ms, Ms, Ms^Qhh
Ms^Qhux, Ha^Qhux, Ms^Qhux, Ms^Qhux, Ms^Qhux, Ha^Qhux, Ha^Qhux, Re, Aa, Aa, Ha, Aa, Aa, Wog, Ai, Ha^Qhh, Aa, Ha^Qhh, Aa, Aa, Re, Aa, Aa, Aa^Fda, Aa, Aa^Fda, Ha, Ha^Qhhf, Ha^Qhh, Ms^Qhh, Ms^Qhh, Ms^Xm, Ms, Ms^Xm, Ms^Xm, Ms
Ms^Xm, Ms^Qhux, Ms^Xm, Ms^Qhux, Ms^Qhux, Ha^Qhux, Aa, Rb, Aa, Ha, Ms, Ms, Ha, Ai, Wog, Ai, Ha, Ha^Qhh, Cha^Qhh, Aa, Rb, Re, Rb, Aa, Aa, Aa, Aa^Fdw, Ha^Fda, Aa, Ha, Ha^Qhh, Ms, Ha^Vka, Ms^Xm, Ms^Xm, Ms^Xm
Ms^Xm, Ms^Xm, Ms^Xm, Ms, Rb, Ha^Qhux, Re, Aa, Ha, Ha, Ms, Ha, Ha, Aa, Wog, Ai, Ha, Ms^Qhh, Chr^Kov, Ha^Vka, Aa, Aa, Rb, Aa, Rb, Re, Aa, Aa, Ha, Ha^Qhhf, Ms, Ms, Ms^_mh, Ms, Ms^Xm, Ms
Ms^Xm, Ms^Xm, Ms^Qhux, Ms^Qhux, Aa, Re, Aa, Aa, Ha, Ms, Ms, Ms, Ms, Ha, Ai, Wog, Ha^Qhh, Ms^Qhh, Ms^Qhh, Chr^Qhh, Ha^Qhh, Aa, Aa^Vka, Aa, Aa, Re, Aa, Aa, Ha^Fda, Ha^Qhhf, Ms^Qhh, Ms^Qhh, Ms^Qhh, Ms^Xm, Ms^Xm, Ha^Qhh
Ms^Qhux, Ms^Qhux, Ha^Qhux, Ha^Qhux, Aa, Re, Aa, Ha, Aa^Vca, Ha, Ha, Ms, Ha, Ms, Aa, Wog, Wog, Ha^Qhh, Ha, Ha, Ha, Ha^Qhh, Ha^Qhh, Ss, Ss, Aa, Re, Aa, Aa, Ha^Fdw, Ha, Ms, Ms, Ms^Qhh, Ms^Qhh, Ms^Xm
Ms^Qhux, Ms^Qhux, Re, Rb, Aa, Aa, Aa, Aa, Ha, Ha, Ha, Ha, Ha, Ha, Ms, Ai, Ai, Ai, Aa^Qhh, Ha, Ms, Ms, Ha^Qhh, Ss, Ai, Aa, Re, Rb, Aa, Ha, Aa, Ha, Aa, Ms^Qhh, Ms, Ms^Xm
Ms^Qhux, Ha^Qhux, Re, Aa, Ha^Vca, Chr, Chr, Ha^Vca, Ms, Ha, Ha^Vca, Ms, Ms, Ms, Ms, Ha, Aa, Wog, Wog^Qhh, Ha, Ha^Qhh, Ms^Qhh, Ha^Qhh, Ha^Qhh, Ha, Ai, Ai, Re, Re, Aa, Aa, Ha, Aa, Ha^Qhh, Ms^Qhh, Ms^Qhh
Re, Ha^Qhux, Aa, Aa, Cha, Chr^Kov, Ms, Ms, Ms, Ms, Ms, Ms, Ms, Ms, Ms, Ha, Ha, Ai, Ss, Wog, Aa, Ha, Ha^_mh, Aa^Qhh, Aa^Qhh, Ai, Aa, Aa, Aa, Aa, Re, Aa, Aa, Ha, Ha^Qhh, Ms^Qhh
Rb, Rb, Aa, Ms, Ms, Ms, Aa, Ms, Ms, Ms, Ms, Ms, Ms^Qhh, Ms^Qhh, Ms^Qhh, Ms^Qhh, Ms^Qhh, Ss, Ss, Wog^Qhh, Ai^Qhh, Aa^Qhh, Ha^Qhh, Ha^Qhh, Ha^Qhh, Aa^Qhh, Aa^Qhh, Aa, Aa, Aa, Aa, Rb, Aa, Aa, Aa, Ha^Qhh
