Xu, Xu, Xu, Xu, Xu, Xu, Xu, Xu, Xu, Xu, Xu, Xu, Xu, Xu, Xu, Xu, Xu, Xu, Xu, Xu, Xu, Xu, Xu, Xu, Xu, Xu, Xu, Xu, Xu, Xu, Wo^Qhh, Wo^Qhh, Xu, Xu, Xu, Xu, Xu, Xu, Xu, Xu, Xu, Xu, Xu, Xu, Xu, Xu, Xu, Xu, Xu, Xu, Xu, Xu, Xu, Xu, Xu, Xu
Xu, Xu, Xu, Xu, Xu, Xu, Xu, Xu, Xu, Xu, Xu, Xu, Xu, Xu, Xu, Xu, Xu^Qhh, Xu, Xu^Qhh, Xu, Xu^Qhh, Xu, Xu, Xu, Xu, Xu, Xu, Xu, Wo^Qhh, Wo^Qhh, Xu, Xu, Xu, Xu, Xu, Xu, Xu, Xu, Xu, Xu, Xu, Xu, Xu, Xu, Xu, Xu, Xu, Xu, Xu, Xu, Xu, Xu, Xu, Xu, Xu, Xu
Xu, Xu, Xu, Xu, Xu, Xu, Xu, Xu, Xu, Xu, Xu, Xu, Xu, Xu, Xu^Qhh, Xu^Qhh, Xu, Xu^Qhh, Xu, Xu^Qhh, Xu, Xu^Qhh, Xu^Qhh, Xu, Xu, Xu, Wo^Qhh, Wo^Qhh, Xu, Xu, Xu, Xu, Xu, Xu, Xu, Xu, Xu, Xu, Xu, Xu, Xu, Xu, Xu, Xu, Xu, Xu, Xu, Xu, Xu, Xu, Xu, Xu, Xu, Xu, Xu, Xu
Xu, Xu, Xu, Xu, Xu, Xu, Xu, Xu, Xu, Xu, Xu, Xu, Xu^Qhh, Xu^Qhh, Xu, Xu, Xu, Xu, Uu^Tf, Xu^_mh, Xu, Xu, Ww^Qhh, Ww^Qhh, Wo^Qhh, Wo^Qhh, Xu, Xu, Xu, Xu, Xu, Xu, Xu, Xu, Xu, Xu, Xu, Xu, Xu, Xu, Xu, Xu, Xu, Xu, Xu, Xu, Xu, Xu, Xu, Xu, Xu, Xu, Xu, Xu, Xu, Xu
Xu, Xu, Xu, Xu, Xu, Xu, Xu, Xu, Xu, Xu, Xu, Xu^Qhh, Xu^Qhh, Xu, Ww^Qhh, Tb^Tf, Ww^Qhh, Tb^Tf, Ww^Qhh, Ww^Qhh, Ww^Qhh, Ww^Xo, Xu, Xu, Xu^Qhh, Xu^Qhh, Xu, Xu, Xu, Xu, Xu, Xu, Xu, Xu, Xu, Xu, Xot, Xor, Xor, Xos, Xor, Xu, Xu, Xu, Xu, Xu, Xu, Xu, Xu, Xu, Xu, Xu, Xu, Xu, Xu, Xu
Xu, Xu, Xu, Xu, Xu, Xu, Xu, Xu, Xu, Xu, Xu, Xu^Qhh, Xu^Qhh, Xu^Qhh, Xu^Qhh, Ww^Qhh, Ww^Qhh, Ww^Qhh, Ww^Qhh, Ww^Qhh, Xu^Qhh, Ww^Qhh, Xu^Qhh, Xu^Qhh, Xu, Xu, Xu, Xu, Xu, Xu, Xu, Xu, Xu, Xor, Xot, Xot, Qlf, Xor, Uh^Qhh, Cud^Xo, Xor, Xor, Xot, Xu, Xu, Xu, Xu, Xu, Xu, Xu, Xu, Xu, Xu, Xu, Xu, Xu
Xu, Xu, Xu, Xu, Xu, Xu, Xu, Xu, Xu, Xu, Xu, Xu, Xu, Xu^Qhh, Xu, Xu^Qhh, Xur^Qhh, Ww, Ww, Ww, Uu^Tf, Xu^Qhh, Xu, Xu, Xu, Xu, Xu, Xu, Xu, Xu, Xu, Xu, Xu, Xor, Cud^Xo, Qlf, Qlf^Ii, Urb, Ur, Uh^Qhh, Qlf^Ii, Ql^Ii, Ql^Ii, Xot, Xor, Xu, Xu, Xu, Xu, Xu, Xu, Xu, Xu, Xu, Xu, Xu
Xu, Xu, Xu, Xu, Xu, Xu, Xu, Xu, Xu, Xu, Xu, Xu, Xu, Xu, Uh^Tf, Xur, Ww^Qhu, Wwf, Wwf, Wwf, Xu, Uu^Tf, Xur, Xu, Xu, Xu, Xu, Xu, Xu, Xu, Xu, Xu, Xor, Xor, Ql, Uu^Qhu, Uu, Urb, Uu, Ur, Uue^Qhu, Uue^Qhu, Qlf, Xor, Cud^Xo, Xor, Xu, Xu, Xu, Xu, Xu, Xu, Xu, Xu, Xu, Xu
Xu, Xu, Xu, Xu, Xu, Xu, Xu^Qhh, Xue^Qhh, Xue^Qhh, Xu, Xue, Xu, Xue, Xu, Xu, Uu^Tf, Ww^Qhu, Ww^Qhu, Xu, Wwf, Xu, Xu, Uh^Qhh, Xur, Uh^Qhh, Xu, Xu, Xu, Xu, Xu, Xu, Xos, Xor, Xor, Ur^Qhu, Urb^Qhu, Qlf, Qlf, Ql^Ii, Ql, Ql, Uue^Qhu, Uu, Urb^Qhh, Xot, Xor, Xor, Xu, Xu, Xu, Xu, Xu, Xu, Xu, Xu, Xu
Xu, Xu, Xu, Xu, Xu, Xu^Qhh, Xue^_mh, Xue, Uhe^Tf, Xue^Qhh, Xue, Xue, Uhe^Tf, Xue, Xu, Uu^Tf, Xu, Wwf, Wwf, Wwf, Ww^Qhu, Ww^Qhu, Ur, Uh^Qhh, Xu, Xu, Xu, Xu, Xu, Xu, Xu, Xos, Cud^Xo, Qlf^Ii, Qlf, Ur, Ql, Qlf^Ii, Qlf^Ii, Qlf, Qlf, Ql, Uu, Urb^Qhh, Urb^Qhh, Xor, Xor, Xu, Xu, Xu, Xu, Xu, Xu, Xu, Xu, Xu
Xu, Xu, Xu, Xu, Xu, Xu^Qhh, Xue^Qhh, Uhe^Tf, Uue^Tf, Xue^Qhh, Tb^Tf, Uhe^Qhh, Xue, Xu, Xu, Xu, Xu, Uu, Ww^Qhu, Uh^Feth, Wwf, Ww^Qhu, Wwf, Ww^Qhu, Ww^Qhu, Xu, Xu, Xu, Xu, Xu, Xu, Xor, Xor, Qlf, Uue^Qhu, Urb, Ql, Qlf, Qlf, Ql, Ql^Ii, Urb, Uu, Qlf^Ii, Ql, Cud^Xo, Xor, Xu, Xu, Xu, Xu, Xu, Xu, Xu, Xu, Xu
Xu, Xu, Xu, Xu, Xu, Xu, Xu, Xue^Qhh, Xue^Qhh, Uue^Qhh, Tb^Tf, Tb^Tf, Xu, Xu, Ur, Xur, Ww^Qhu, Ww^Qhu, Xu, Ww^Qhu, Ww^Qhu, Wwf, Uh^Qhh, Ww^Qhu, Ur, Uh^Vud, Uh^Qhh, Xu, Xu, Xu, Xu, Xu, Xor, Uue^Qhu, Urb, Uu, Urb, Urb, Uu, Urb, Uu, Uh^Qhh, Uh^Qhh, Ql, Ql, Xor, Xu, Xu, Xu, Xu, Xu, Xu, Xu, Xu, Xu, Xu
Xu, Xu, Xu, Xu, Xu, Xu, Xu, Xue, Xur, Uhe^Tf, Uue^Tf, Tb, Ur, Ur, Xu, Ur, Uu^Qhu, Ww^Qhu, Xu, Xu, Ww^Qhu, Ww^Qhu, Xu, Xu, Uu^Qhu, Ur, Uh, Xur, Xu, Xu, Xor, Xos, Urb, Urb^Pr\o, Urb^Pr\o, Uu, Uh^Qhh, Uh^Qhh, Qlf^Ii, Uu, Qlf, Uh^Qhh, Cud^Xo, Xor, Xor, Xor, Xu, Xu, Xu, Xu, Xu, Xu, Xu, Xu, Xu, Xu
Xu, Xu, Xu, Xu, Xu, Xu, Xu, Xu, Uu^Qhh, Uu^Qhh, Tb, Tb^Tf, Xu, Xu, Xu, Xu, Xu, Ww^Qhu, Qxu, Qxu, Qxu, Qxu, Qxu, Xu, Uh^Qhu, Rb, Ur, Xu, Ur, Xor, Urb^Pr\o, Urb, Urb, Urb, Xor, Xor, Xor, Uh^Qhh, Cud^Xo, Qlf^Ii, Xor, Xor, Xor, Xor, Xu, Xu, Xu, Xu, Xu, Xu, Xu, Xu, Xu, Xu, Xu, Xu
Xu^Qhh, Xu, Xu^Qhh, Xu, Xu, Xu, Xu, Xu, Xu, Uh^Tf, Uh^Tf, Rb^Qhu, Xur, Xu, Xu, Xu, Xu, Qxu, Qxu, Qxu, Qxu, Qxu, Qxu, Qxu, Qxu, Uu^Qhu, Xu, Uu, Ur, Uu, Urb, Urb^Pr\o, Xos, Xos, Xu, Xu, Xu, Xu, Xu, Xor, Xu, Xu, Xu, Xu, Xu, Xu, Xu, Xu, Xu, Xu, Xu, Xu, Xu, Xu, Xu, Xu
Xu^Qhh, Xu^Qhh, Xu, Xu^Qhh, Xu^Qhh, Xu, Xu, Xu, Xur, Uh^Tf, Xu, Ur, Uu^Qhu, Xu, Qxu, Xur, Qxu, Qxu, Qxu, Qxu, Qxu, Qxu, Qxu, Qxu, Qxu, Qxu, Xu, Xu, Uu^Qhu, Ur, Ur, Xu, Qlf, Xu, Xu, Xu, Xu, Xu, Xu, Xu, Xu, Xu, Xu, Xu, Xu, Xu, Xu, Xu, Xu, Xu, Xu, Xu, Xu, Xu, Xu, Xu
Ms^Qhh, Xu, Xu, Xu, Xu^Qhh, Uhe^Ii, Uh^Ii, Xur, Uu, Xur, Ur, Ur, Ur, Uh^Qhu, Qxu, Qxu, Qxu, Qxu, Qxu, Qxu, Qxu, Qxu, Qxu, Qxu, Qxu, Qxu, Qxu, Uu^Qhu, Uu^Qhu, Uh^Vu, Uhe^Qhh, Ur, Qlf, Qlf, Qlf, Xu, Xu, Xu, Xu, Xu, Xu, Xu, Xu, Xu, Xu, Xu, Xu, Xu, Xu, Xu, Xu, Xu, Xu, Xu, Xu, Xu
Ms^Qhh, Ms, Ms, Xu, Ha^Qhh, Uu^Ii, Ur, Ur, Uu, Uu, Uu, Uu, Xu, Uu^Qhu, Xu, Qxu, Qxu, Qxu, Qxu^Qhh, Qxu, Qxu, Qxu, Qxu, Qxu, Qxu, Qxu, Qxu, Qxu, Xu, Xu, Xue, Ur, Uu^Qhu, Uu^Qhu, Uu^Qhu, Xu, Xu, Xu, Xu, Xu, Xu, Xu, Xu, Xu, Xu, Xu, Xu, Xu, Xu, Xu, Xu, Xu, Xu, Xu, Xu, Xu
Aa^Qhh, Ha, Ha, Ha, Xur, Uhe^Qhh, Xu, Xu, Xu, Uu^Ii, Uh^Qhh, Ur, Ur, Xur, Xu, Xu, Qxu^Qhh, Qxu^Qhh, Qxu, Qxu^Qhh, Qxu^Qhh, Qxu, Xu^Qhh, Qxu, Xu^Qhh, Qxu, Qxu, Qxu, Xue, Xu, Xue, Uu^Qhu, Xuc, Xuc, Xuc, Uhe^Qhh, Xu, Xu, Xu, Xu, Xu, Xu, Xu, Xu, Xu, Xu, Xu, Xu, Xu, Xu, Xu, Xu, Xu, Xu, Xu, Xu
Aa^Qhh, Aa^_mh, Ms, Ms, Xu, Xu^Qhh, Xu, Xu, Xu, Uh^Qhh, Uh^Qhh, Uu, Ur^Qhh, Uh^Qhh, Xos^Qhh, Xos^Qhh, Xor^Qhh, Qxu, Qxu, Qxu, Qxu, Qxu^Qhh, Xu^Qhh, Xu^Qhh, Xu^Qhh, Qxu, Xu, Xu, Xue, Xue, Ur, Uu^Qhu, Xuc, Xuc, Ur, Uhe^Qhh, Xu, Xu, Xu, Xu, Xu, Xu, Xu, Xu, Xu, Xu, Xu, Xu, Xu, Xu, Xu, Xu, Xu, Xu, Xu, Xu
Ha^Qhh, Ha, Xu, Xu, Xu^Qhh, Xu^Qhh, Xu, Xu, Xu, Xu, Xu, Xur, Xos^Qhh, Isa^Dr, Isa, Isa^Xo, Isa, Xor^Qhh, Sm^Dr, Uu^Qhu, Uhe^Qhh, Qxu, Xu^Qhh, Xu^Qhh, Qxu, Qxu, Qlf, Xu, Xue, Uhe^Dr, Uhe^Qhh, Ur, Ur, Ur, Qlf^Qhu, Xu, Xu, Xu, Xu, Xu, Xu, Xu, Xu, Xu, Xu, Xu, Xu, Xu, Xu, Xu, Xu, Xu, Xu, Xu, Xu, Xu
Ms^Qhh, Ha, Xu^Qhh, Xu^Qhh, Xu, Xu, Xu, Xu, Xu, Xu, Xot, Xos, Isa, Isa^Qhh, Isa^Qhh, Isa^Dr, Isa^Xo, Sm, Sm, Xor, Xor^Qhh, Xu^Qhh, Xuc, Xuc, Qxu, Ql^Qhu, Qlf, Xu, Xue, Xur, Qlf^Qhu, Ur, Uhe, Ur, Uhe^Qhh, Uhe^Qhh, Xu, Xu, Xu, Xu, Xu, Xu, Xu, Xu, Xu, Xu, Xu, Xu, Xu, Xu, Xu, Xu, Xu, Xu, Xu, Xu
Xu^Qhh, Xu^Qhh, Xu, Xu, Xu, Xu, Xu, Xu, Xos, Xot, Isa^Qhu, Isa^Qhu, Isa^Dr, Rp, Rr, Isa^Qhh, Isa^Qhh, Isa^_mh, Isa^Dr, Isa^Xo, Xor^Qhh, Xue, Ql^Qhu, Qxu, Xur, Xur, Xur, Xu, Xur, Uhe^Dr, Uhe^Dr, Uhe^Dr, Xur, Qlf^Qhu, Uhe^Qhh, Xue, Xu, Xu, Xu, Xu, Xu, Xu, Xu, Xu, Xu, Xu, Xu, Xu, Xu, Xu, Xu, Xu, Xu, Xu, Xu, Xu
Xu, Xu, Xu, Xu, Xu, Xu, Xos, Xot, Cud^Xo, Isa^Qhu, Isa, Isa^Dr, Rr^Vd, Rr, Isa, Isa, Isa, Rp^Qhh, Xos^Qhh, Isa^Pr/, Qlf^Qhh, Xuc, Qlf, Qlf^Qhu, Qlf, Xur, Ql^Qhu, Xur, Xur, Xur, Xur, Xur, Xu, Xue, Xue, Xue, Xu, Xu, Xu, Xu, Xu, Xu, Xu, Xu, Xu, Xu, Xu, Xu, Xu, Xu, Xu, Xu, Xu, Xu, Xu, Xu
Xu, Xu, Xu, Xu, Xu, Xu, Xu, Xos, Xos, Isa, Rp, Isa, Rp^Dr, Isa, Isa^Qhu, Isa^Qhu, Xos, Xos, Xue, Qlf^Qhh, Qlf^Qhh, Ql^Qhu, Qlf^Qhu, Qlf^Qhu, Qlf^Qhh, Qlf, Qlf^Qhh, Ql^Qhu, Xur, Xu, Xu, Xu, Xu, Xu, Xu, Xu, Xu, Xu, Xu, Xu, Xu, Xu, Xu, Xu, Xu, Xu, Xu, Xu, Xu, Xu, Xu, Xu, Xu, Xu, Xu, Xu
Xu, Xu, Xu, Xu, Xu, Xu, Xu, Uh^Qhh, Ur, Rp^Pr\o, Xor, Rr, Cud^Xo, Isa^Qhu, Xos, Xos, Xu, Xu, Xuc, Qlf, Xuc, Qlf^Qhh, Xuc, Qlf^Qhh, Ql^Qhu, Qlf, Xu, Xu, Xu, Xu, Xu, Xu, Xu, Xu, Xu, Xu, Xu, Xu, Xu, Xu, Xu, Xu, Xu, Xu, Xu, Xu, Xu, Xu, Xu, Xu, Xu, Xu, Xu, Xu, Xu, Xu
Xu, Xu, Xu, Xu, Xu, Xu, Xu, Uh^Qhh, Uu, Rr, Ur^Qhu, Xor, Xu, Xos, Xu, Xu, Xu, Xu, Xu, Xuc, Xu, Xuc, Xu, Xue, Xu, Xue, Xu, Xu, Xu, Xu, Xu, Xu, Xu, Xu, Xu, Xu, Xu, Xu, Xu, Xu, Xu, Xu, Xu, Xu, Xu, Xu, Xu, Xu, Xu, Xu, Xu, Xu, Xu, Xu, Xu, Xu
Xu, Xu, Xu, Xu, Xu, Xu, Xu, Ur^Qhu, Ur^Qhu, Ur^Qhu, Uu^Dr, Xu, Xu, Xu, Xu, Xu, Xu, Xu, Xu, Xu, Xu, Xu, Xu, Xu, Xu, Xu, Xu, Xu, Xu, Xu, Xu, Xu, Xu, Xu, Xu, Xu, Xu, Xu, Xu, Xu, Xu, Xu, Xu, Xu, Xu, Xu, Xu, Xu, Xu, Xu, Xu, Xu, Xu, Xu, Xu, Xu
Xu, Xu, Xu, Xu, Xu, Xu, Xu, Xu, Ur^Qhu, Uu, Xu, Xur, Xur, Xu, Xu, Xu, Xu, Xu, Xu, Xu, Xu, Xu, Xu, Xu, Xu, Xu, Xu, Xu, Xu, Xu, Xu, Xu, Xu, Xu, Xu, Xu, Xu, Xu, Xu, Xu, Xu, Xu, Xu, Xu, Xu, Xu, Xu, Xu, Xu, Xu, Xu, Xu, Xu, Xu, Xu, Xu
Xu, Xu, Xu, Xu, Xu, Xu, Xur, Xur, Ur^Qhu, Ur^Qhu, Uu^Dr, Uh^Qhh, Uu^Dr, Xur, Xu, Xu, Xu, Xu, Xu, Xu, Xu, Xu, Xu, Xu, Xu, Xu, Xu, Xu, Xu, Xu, Xu, Xu, Xu, Xu, Xu, Xu, Xu, Xu, Xu, Xu, Xu, Xu, Xu, Xu, Xu, Xu, Xu, Xu, Xu, Xu, Xu, Xu, Xu, Xu, Xu, Xu
Xu, Xu, Xu, Xu, Sm, Xur, Ur^Qhu, Uu, Uu, Uu, Xu, Wwg^Qhu, Uh^Qhh, Xur, Xu, Xu, Xu, Xu, Xu, Xu, Xu, Xu, Xu, Xu, Xu, Xu, Xu, Xu, Xu, Xu, Xu, Xu, Xu, Xu, Xu, Xu, Xu, Xu, Xu, Xu, Xu, Xu, Xu, Xu, Xu, Xu, Xu, Xu, Xu, Xu, Xu, Xu, Xu, Xu, Xu, Xu
Xu, Xu, Ur^Qhu, Uh^Qhh, Uu, Uu, Ur^Qhu, Ur^Qhu, Xu, Xu, Xu, Uh^Qhh, Xu, Xu, Xu, Xu, Xu, Xu, Xu, Xu, Xu, Xu, Xu, Xu, Xu, Xu, Xu, Xu, Xu, Xu, Xu, Xu, Xu, Xu, Xu, Xu, Xu, Xu, Xu, Xu, Xu, Xu, Xu, Xu, Xu, Xu, Xu, Xu, Xu, Xu, Xu, Xu, Xu, Xu, Xu, Xu
Uu, Ur^Qhu, Uh, Ur^Qhu, Uu, Uu, Xu, Xu, Xu, Xu, Xu, Xu, Xu, Xu, Xu, Xu, Xu, Xu, Xu, Xu, Xu, Xu, Xu, Xu, Xu, Xu, Xu, Xu, Xu, Xu, Xu, Xu, Xu, Xu, Xu, Xu, Xu, Xu, Xu, Xu, Xu, Xu, Xu, Xu, Xu, Xu, Xu, Xu, Xu, Xu, Xu, Xu, Xu, Xu, Xu, Xu
Xu, Xu, Xu, Xu, Xu, Xu, Xu, Xu, Xu, Xu, Xu, Xu, Xu, Xu, Xu, Xu, Xu, Xu, Xu, Xu, Xu, Xu, Xu, Xu, Xu, Xu, Xu, Xu, Xu, Xu, Xu, Xu, Xu, Xu, Xu, Xu, Xu, Xu, Xu, Xu, Xu, Xu, Xu, Xu, Xu, Xu, Xu, Xu, Xu, Xu, Xu, Xu, Xu, Xu, Xu, Xu
Xu, Xu, Xu, Xu, Xu, Xu, Xu, Xu, Xu, Xu, Xu, Xu, Xu, Xu, Xu, Xu, Xu, Xu, Xu, Xu, Xu, Xu, Xu, Xu, Xu, Xu, Xu, Xu, Xu, Xu, Xu, Xu, Xu, Xu, Xu, Xu, Xu, Xu, Xu, Xu, Xu, Xu, Xu, Xu, Xu, Xu, Xu, Xu, Xu, Xu, Xu, Xu, Xu, Xu, Xu, Xu
Xu, Xu, Xu, Xu, Xu, Xu, Xu, Xu, Xu, Xu, Xu, Xu, Xu, Xu, Xu, Xu, Xu, Xu, Xu, Xu, Xu, Xu, Xu, Xu, Xu, Xu, Xu, Xu, Xu, Xu, Xu, Xu, Xu, Xu, Xu, Xu, Xu, Xu, Xu, Xu, Xu, Xu, Xu, Xu, Xu, Xu, Xu, Xu, Xu, Xu, Xu, Xu, Xu, Xu, Xu, Xu
Xu, Xu, Xu, Xu, Xu, Xu, Xu, Xu, Xu, Xu, Xu, Xu, Xu, Xu, Xu, Xu, Xu, Xu, Xu, Xu, Xu, Xu, Xu, Xu, Xu, Xu, Xu, Xu, Xu, Xu, Xu, Xu, Xu, Xu, Xu, Xu, Xu, Xu, Xu, Xu, Xu, Xu, Xu, Xu, Xu, Xu, Xu, Xu, Xu, Xu, Xu, Xu, Xu, Xu, Xu, Xu
Xu, Xu, Xu, Xu, Xu, Xu, Xu, Xu, Xu, Xu, Xu, Xu, Xu, Xu, Xu, Xu, Xu, Xu, Xu, Xu, Xu, Xu, Xu, Xu, Xu, Xu, Xu, Xu, Xu, Xu, Xu, Xu, Xu, Xu, Xu, Xu, Xu, Xu, Xu, Xu, Xu, Xu, Xu, Xu, Xu, Xu, Xu, Xu, Xu, Xu, Xu, Xu, Xu, Xu, Xu, Xu
Xu, Xu, Xu, Xu, Xu, Xu, Xu, Xu, Xu, Xu, Xu, Xu, Xu, Xu, Xu, Xu, Xu, Xu, Xu, Xu, Xu, Xu, Xu, Xu, Xu, Xu, Xu, Xu, Xu, Xu, Xu, Xu, Xu, Xu, Xu, Xu, Xu, Xu, Xu, Xu, Xu, Xu, Xu, Xu, Xu, Xu, Xu, Xu, Xu, Xu, Xu, Xu, Xu, Xu, Xu, Xu
