Hh^Qhh, Hh^Es, Mm^Qhh, Gg^Qhh, Hh^Qhhf, Gg^Fms, Hh^Fms, Gg, Gs^Fp, Gg, Gs^Fp, Gs^Fms, Gs^Fp, Re^Qhu, Gg^Qhuf, Re, Rb, Re, Re, Gs, Gs, Gd, Ds^Edp, Ds^_ml, Dd^Qhu, Dd^Qhu, Ds^Qhu, Ds^Qhh, Gg^Qhh, Gs^Qhh, Hh^Qhh, Mm^Qhh, Mm^Qhh, Mm^Qhh, Mm^Qhh, Gs^Qhh, Gs^Qhh, Gg^Qhh, Gg^Qhh, Gg, Hh^Qhh, Re, Gs^Vl, Gg^Qhh, Gs^Qhh, Gs^Qhh
Gg, Hh^Qhh, Mm^Qhh, Mm^Xm, Mm^Xm, Mm^Qhh, Mm^Xm, Hh, Gs^Fms, Gg, Gg, Gg, Gs^Fp, Gs^Fms, Gs^Fds, Rb^Qhu, Rb, Re, Rb, Re, Rb, Gs, Gd, Dd^Qhu, Gs^Efm, Dd^Qhu, Dd^Qhu, Ds^Qhu, Ds^Qhu, Dd^Qhu, Hd^Qhu, Hh^Qhh, Hh^Qhh, Mm^Qhh, Mm^Qhh, Hh^Fp, Gg, Gs, Gg, Gg^Qhh, Gg^Fp, Mm^Qhh, Mm, Hh^Qhh, Hh^_mhh, Hh^Qhh
Hh, Hh, Hh, Mm^Qhh, Hh^Qhh, Mm^Xm, Mm^Qhh, Hh^Qhhf, Hh, Gg, Gs^Fms, Gs^Fds, Gs^Fds, Gg, Gs^Fms, Gg^Qhu, Gg^Qhu, Gg, Gg, Re, Re, Re, Rb, Gg^Qhu, Gs^Qhu, Gs^Efm, Gs, Hd^Qhu, Ds, Ds^Qhu, Dd^Qhu, Hd^Qhu, Ds, Gs, Hh, Hh^Qhh, Hh^Qhh, Hh, Hh^Es, Gg^_mh, Gg^Efm, Hh^Qhhf, Mm^Qhh, Mm^Xm, Mm^Xm, Hh^Qhh
Gg, Hh, Gs, Hh, Gg, Hh^Qhh, Gg, Mm^Qhh, Hh^Qhh, Gg, Gg, Gg, Gg, Gs^Fms, Gg^Qhuf, Gg^Qhuf, Gg, Gg^Qhu, Gg^Qhu, Gg, Re, Rb, Re, Gg, Gg^Qhu, Gs^Efm, Gs, Ds, Ds, Gs, Gs, Gs, Ds, Gs^Efm, Gg^Efm, Hh, Gg, Hh^Qhh, Gg^Qhh, Hh, Gg^Efm, Gg^Fms, Hh, Mm^Qhh, Hh^Qhh, Hh
Gs^Edb, Gg, Gs^Dr, Gg, Gg^Fp, Gs, Gg^Fms, Hh, Hh, Hh^Qhh, Hh^Qhh, Gg^Fms, Gg, Gg^Qhu, Gg^Qhu, Cer^Dr, Gg^Fms, Cer^Edb, Cer^Edb, Gg^Efm, Gg^Efm, Rb, Rb, Re, Gs, Gs^Qhu, Gs^Qhu, Gg, Gg^Efm, Gg, Gg, Gs, Gg, Gg, Gg, Ds, Ds, Gg, Ds, Gg^Qhh, Gg^Qhh, Gg^Qhh, Gg^Qhh, Hh, Gg, Hh^Qhh
Gs, Gs, Gg^Fms, Gg^Fms, Gg, Gg^Fp, Gg^Fds, Gg, Gg, Gg, Gs, Gg, Gg, Gg, Gg, Gs, Gs, Ker^Qhu, Rb, Cer^Dr, Gg^Fms, Gg^Efm, Re, Re^Edb, Re, Gg^Edb, Gs^Vhr, Gd^Qhu, Gs, Gs^Efm, Gs, Gs, Cer^Edb, Gs, Gg, Gg, Ds, Ds^Edp, Dd, Ds, Gg, Gg, Dd, Gg^Qhh, Gg^Qhh, Gg
Gg, Gs, Gg, Gg^Fp, Gg, Gg, Gg, Gg^Fds, Gg, Gg, Gg, Gs, Gs, Gs, Rb^Dr, Rb^Vct, Rb, Rb, Re^Vct, Gg^Qhu, Gg^Fms, Re, Rb^Qhu, Re, Gg, Gs^Edb, Gs^Qhu, Gd^Qhu, Gs, Gg^Dr, Cer^Dr, Cer^Edb, Ker, Cer^Dr, Gg, Gg, Gg, Ds, Gg, Ds, Ds, Gs, Gg, Ds, Ds, Gg^Qhh
Gg, Gg, Gg, Gg, Gg, Gg, Gs, Gg, Cer^Edb, Gg, Re^Dr, Gs, Gs, Gs^Ecf, Re^Edb, Re^Edb, Gs^Dr, Gs^Edb, Rb, Rb^Fp, Gs, Rb^Qhu, Rb^Edb, Gs^Edb, Gg^Edb, Gg, Gs^Qhu, Gs, Gg, Gg, Gg^Edb, Gg, Gg, Gg^Edb, Gg, Gg^Edb, Gs, Gg, Gg, Ds, Gg, Gg, Gg^Efm, Gg, Dd, Dd
Gs, Gg, Gs, Gg, Gs^Fms, Gg, Gs^Edb, Gs^Edb, Cer^Edb, Re^Dr, 2 Ker^Qhu, Rb, Gd, Gd^Edb, Rb^Edb, Gd^Dr, Gs^Vct, Gg, Gg, Gs, Re^Edb, Gs^Ecf, Re, Re, Gs, Gg^Edb, Gs^Qhu, Gs, Gs^Efm, Gg, Gs, Gg, Gd^Edb, Gs, Gd, Gd, Gs^Vc, Gs^Edb, Gs^Edb, Gs, Gg, Gg^Efm, Gg^Efm, Gg, Gs, Dd
Gs^Vl, Gg^Fms, Gg, Gs^Fp, Gs, Gs, Gs, Gs, Gs^Edb, Gs, Cer, Cer^Dr, Gs, Gs^Vct, Re, Rb, Rb^Ecf, Rb, Gs, Gs^Ecf, Gd^Edb, Re, Rb, Rb, Gs^Edb, Gs^Edb, Gg^Ecf, Gd^Qhu, Gs, Gg, Gg^Efm, Gs^Edb, Gs^Vc, Gd^Edb, Rb, Rb^Edb, Rb, Re, Re, Gs, Re, Gg, Gg, Gg, Gs^Efm, Gs
Gs, Gs, Gs^Edb, Gg, Gg^Edt, Gs^Edb, Gd, Gd, Gs, Gg, Gg^Edb, Gs, Gs^Edb, Re, Gs^Dr, Re, Re, Rb, Gd, Gd, Re, Re, Re, Gs^Edb, Gg^Vct, Gg, Gg, Gd^Qhu, Gd^Qhu, Gg^Efm, Gg^Edb, Gs, Gs, Gd, Gs, Gs, Gd, Gd^Vc, Gd^Edb, Re, Rb, Rb, Gg^Efm, Gs, Gg^Efm, Gs^Efm
Gg^Fms, Gg^Fp, Gg^Fms, Gg, Gg, Co^Edt, Co^Edt, Gd^Dr, Co, Hh, Hh, Hh^Edb, Gg, Gs^Edb, Gs^Ecf, Re^Edb, Gs^Edb, Gs^Dr, Rb, Gd, Re, Re, Gd^Ecf, Re^Vct, Gs^Dr, Gg^Edb, Gg, Gg, Gs^Edb, Gd^Qhu, Gg^Efm, Gs, Cer, Cer^Dr, Ker, Cer, Gd^Dr, Gs, Gg, Gs^Edb, Gg, Gg^Efm, Gg, Rb, Rb, Rb
Gg^Fms, Gg^Fms, Hh, Gg^Fds, Hh, Co^Dr, Co^Kov, Rb^Dr, Gs^Edb, Hh^Edb, Co^Edb, Co^Dr, Gg^Dr, Gg^Dr, Gg, Gs^Edb, Re, Re^Edb, Re, Gs^Vct, Rb, Rb, Rb, Co, Gs, Gg, Ds, Gg, Gs, Ds^Qhu, Hd^Qhu, Gg, Gg^Edb, Gg^Edb, Ds, Cer^Dr, Ds, Gg, Ds, Gg, Gg, Gg, Cer^Edb, Gs, Gs, Gg
Ww, Ds, Ds, Hh, Hh, Hh, Hh, Gd, Hhd^Dr, Gd, Gd^Vo, Co^Dr, Co^Edt, Gg^Edb, Gs^Dr, Gg, Gg, Rb^Edb, Gg^Qhu, Re, Rb^Dr, Re, Wwg, Rb^Dr, Wwg, Ds, Ds, Gd^Dr, Ds^Edb, Ds, Wwg^Qhu, Gg, Wwg^Qhu, Wwg^Qhu, Wwg^Qhu, Ds, Ds, Ds, Ds, Gg^Edb, Gs, Cer^Edb, Ker, Gs, Gs^Edb, Gd
Ww, Ww, Ds^Edb, Hh^Fp, Gg^Edb, Co^Dr, Co, Gs^Edb, Gd^Vo, Gd, Hd^Dr, Co^Kov, Ds^Edt, Ds^Edb, Ds, Ds, Wwrg, Gg, Gg, Co^Dr, Gg, Wwg, Wwg, Wwg, Wwg, Wwg, Wwg, Ds, Wwg, Wwg, Wwg^Qhu, Wwg^Qhu, Wwg, Wwg^Qhu, Ww^Qhu, Ww^Qhu, Ww^Qhu, Ww^Qhu, Ww^Qhu, Ds, Ds, Gs, Gd, Cer, Cer, Gd
Ww, Ww, Ds, Ds, Gg, Gs^Edb, Ds, Ds, Ds, Co^Dr, Hh^Edb, Ds^Dr, Ds, Ds, Wwg, Wwrg, Wwg, Wwg, Wwg, Gg, Wwf, Wwg, Wwg, Wwg, Wwg, Wwg, Wwg, Wwg, Wwg, Wwg, Ww^Qhu, Ww, Ww, Ww, Ww, Ww, Ww, Ww, Wwr^Qhu, Ds, Ds, Gd^Vht, Gs^Edb, Cer, Gg^Edb, Gg
Ww, Ww, Ww, Ds, Wwg, Ds, Wwg, Ds^Edb, Ds^Edb, Hh^Edb, Hh, Ds, Wwrg, Ds, Wwg, Wwg, Wog, Wog, Wog, Wwf, Wwf, Wwg, Wwg, Wwg, Wog, Wog, Wog, Wwg, Ww, Ww, Ww, Ww, Ww, Ww, Ww, Ww, Ww, Ww, Ww, Wwr^Qhu, Wwr^Qhu, Gs, Gg, Gs, Gg^Edb, Gg
Wwg, Ww, Wwg, Wwg, Wwg, Wwg, Wwg, Wwg^Edb, Wwg, Wwg, Wwg, Wwg, Wwg, Wwg, Wwg, Wwg, Wog, Wog, Ds, Wog, Ds, Wwf, Ww, Ww, Wo, Wo, Ww, Ww, Ww, Ww, Wo, Ww^_ml, Ww, Ww, Wo, Ww, Ww, Ww, Ww, Wwr^Qhu, Ww^Qhu, Gg, Gg^Edb, Ds, Ds, Gg
