Gg^Fms, Gg^Fms, Gs, Gd^Qhh, Gg^Qhh, Gg^Qhh, Hh^Qhh, Hh^Qhh, Gs^Qhh, Gg^Qhh, Gg^Qhh, Gs^Qhh, Gd^Qhh, Gg^Qhh, Gd^Qhh, Gg^Qhh, Gd^Qhh, Gg^Qhh, Gd^Qhh, Gg^Qhh, Gg^Qhh, Gg^Qhh, Gs^Qhh, Hh^Qhh, Hh^Qhh, Gs, Hh, Hh, Hh, Gg, Ds, Gs, Ds, Ds, Ds, Gg, Gg^Efm, Gg, Gg, Rb, Gg, Gg, Gg, Gg, Re, Rb, Gg, Rb, Re, Rb, Gg^Fms, Gg^Fms, Gg, Gg, Gg^Fds, Gg^Fds, Gg, Gg, Gg, Gg, Gg, Gg^Fms
Gg^Fds, Gs, Gd, Gs, Gg, Gd^Qhh, Gd^Qhh, Hh, Hh, Hh, Gd^Edt, Gd, Gg^Ecf, Gd, Gs^Vhr, Gs, Gd, Gd, Gg, Gd^Edt, Gs^Qhh, Cer^Edt, Gd^Qhh, Hh^Qhh, Gs, Hh, Dd, Ds, Gs, Ds, Dd, Dd, Gs, Gg, Gg, Gg, Gg^Efm, Gg, Gg, Gg, Gg, Rb^Vct, Rb^Vct, Rb, Re^Vct, Gg, Re, Rb, Ce, Rb, Gg, Gg, Gg, Gg^Fds, Gg, Gg, Gg^Fds, Gg, Gg, Gg, Gg, Gg^Fms
Hh, Gg^Fms, Gg^Fms, Gg^Fms, Gs, Gs, Gd, Gs^Qhh, Gd^Es, Gs, Cer, Cer, Gs, Gs, Gs, Gg, Gs^Vhr, Gd^Vhr, Gs^Qhh, Gs^Qhh, Hh^Es, Gs^Qhh, Hh, Ds, Gs, Dd, Ds, Ds, Ds, Dd, Gg, Ds, Gg, Gg, Gg^Efm, Gg^Efm, Gg^Efm, Gg, Gg, Rb, Re^Vct, Re, Gg, Rb, Re^Vct, Rb, Gg, Ce, Ce, Ke, Ce, Gg, Gg, Gg, Gg^Fds, Gg, Gg, Gg^Fds, Gg, Gg, Gg^Fds, Gg
Gg, Hh, Hh, Gs^Fds, Gg, Gs, Gs, Hh^Qhh, Gs^Qhh, Gg, Cer^Edt, Ker, Gs, Cer^_mh, Cer^Edt, Gs^Edt, Gs^Ecf, Gd, Gs^Qhh, Hh, Gs^Edt, Ds, Ds, Ds, Ds, Ds, Gs, Gs, Gs, Gs, Gs, Gg, Gg^Efm, Gg, Gg^Efm, Gg, Gg, Gg, Gg, Rb, Gg, Re, Gg, Gg, Gg, Gg, Gg, Gg, Gg^Fms, Ce, Gg, Gg, Gg, Gg^Fms, Gg^Fds, Gg^Fds, Gg, Gg, Gg, Gg^Fms, Gg, Gg
Gg^Fds, Gg, Gg^Fds, Gg, Gg, Gs^Fds, Gs, Gs, Gg^Es, Hh^Qhh, Gg^Qhh, Gg^Edt, Gd^Edt, Cer^Edt, Gs, Gs, Gd^Edt, Gs^Edt, Gd^Edt, Gg^Qhh, Ds, Ds^Edt, Gs, Gs, Gs, Gs, Gs, Gg, Gg, Gs, Gg^Efm, Gg^Efm, Gg, Gg^Efm, Gg^Efm, Gg, Gg, Gg, Gg^Efm, Gg, Gg, Gg, Gg^Efm, Gg, Gg^Efm, Gg, Gg, Gg^Fms, Gg, Gg, Gg^Fms, Gg^Fds, Gg, Gg, Gs, Gg, Gg, Gs, Gg^Eff, Gg, Gg, Gg
Gg, Gg, Gg, Gg, Hh^Fds, Gg^Fds, Gg, Gg, Gg, Hh, Gg^Qhh, Gd^Vhr, Gs^Edt, Gs, Gs^Es, Cer^Edt, Cer, Cer^Edt, Cer^Edt, Gs^Qhh, Ds, Gd, Gg, Gs, Gg, Gs, Gs, Gg, Gs, Gg, Gg^Fds, Gg, Gg, Gg, Gg, Gg, Gg, Gg, Gg, Gg^Efm, Gg^Efm, Gg^Efm, Gg, Gg^Efm, Gg, Gg, Gg, Gg, Gs, Gs, Gg, Gg, Gs, Gs, Gs, Gs, Gg^Eff, Gg^Eff, Rb^Gvs, Gg, Gg^Gvs, Gg^Gvs
Gg, Gg, Gg, Gg, Gg, Hh, Gg, Gg, Gg, Hh^Fds, Hh^Es, Gg^Qhh, Gg^Qhh, Gd^Ecf, Gd^Qhh, Gs, Gs^Qhh, Ker, Hh^Qhh, Gd^Qhh, Gd, Gs, Gs, Gg, Gg, Gg, Gg, Gg, Gg, Gg, Gg, Gg, Gs, Gg, Gs, Gg, Gg, Gg, Gs, Gg, Gg, Gg, Gg, Gs, Gg, Gg, Gg^Fds, Gg^Fds, Gg, Gg, Gg, Gg, Gs, Gs, Gg^Eff, Gg^Eff, Rb^Gvs, Rb^Gvs, Re^Gvs, Rb^Gvs, Rb^Gvs, Gg
Rr, Rr, Rp^Edt, Gg, Rp, Gg, Gg, Gg^Fms, Gg, Gs, Gs, Gd, Gd, Gg^Qhh, Hh, Gs^Qhh, Hh, Hh^Qhh, Gg, Gs, Gd^Edt, Gs^Es, Gs, Gg^Fds, Gg^Fds, Gg, Gg^Fms, Gg, Gg, Gg, Gg, Gs, Gs, Gs, Gg, Gg, Gg^Fms, Gs, Gg, Gs, Gs, Gg, Gg^Fms, Gg, Gs, Gg, Gg, Gs^Vl, Gg, Gg, Gg, Gs, Gs^Eff, Gs^Eff, Rb^Gvs, Re^Gvs, Re^Gvs, Re^Gvs, Re^Gvs, Rb^Gvs, Re^Gvs, Rb^Gvs
Rr, Rr^Edt, Rr^Cov, Rp, Rp, Rp^Edt, Gg^Edt, Gg, Gg^Fds, Gs, Gg, Gg^Edt, Gs, Gd, Gg^Edt, Hh, Hh, Hh^Es, Qxu, Gs, Gs, Gs, Gg, Gg, Gg, Gg, Gg, Gg, Gg, Gg, Gg, Gg, Gg, Gg, Gg^Fds, Gg^Fds, Gg, Gg^Fms, Gg, Gg, Gs, Gs, Gs, Gg, Gs, Gs, Gs, Gg, Gs, Gs, Gs^Eff, Gg^Eff, Gg^Gvs, Gg^Gvs, Re^Gvs, Re^Gvs, Re^Gvs, Re^Gvs, Re^Gvs, Re^Gvs, Rb^Gvs, Rb^Gvs
Rr, Rr^Edt, Rr, Rr^Kov, Rr^Cov, Rr, Rp^Edt, Gg, Rp, Gg, Gg, Gg, Gs, Gs^Edt, Gs^Edt, Gs, Gg, Gs, Gg, Gs, Gs, Gg, Gg^Fds, Gg, Gg^Fds, Gg, Gg, Gg, Gg, Gg^Fds, Gg, Gg, Gg^Fms, Gg, Gg, Gg^Fms, Gg, Gs, Gs, Gg, Gg, Gg, Gg, Gs, Re, Gg, Re, Gs, Gg, Gs, Gg, Gg^Eff, Gg, Re^Gvs, Re^Gvs, Rb^Gvs, Rb^Gvs, Re^Gvs, Rb^Gvs, Rb^Gvs, Gg^Gvs, Gg^Gvs
Hh, Rr, Gg, Rr, Rr^Edt, Rr, Rr, Rr, Rr, Rp, Rp^Edt, Gg, Gg, Gs, Gg, Gs, Gg, Gg, Gg, Qxu, Gg, Gg, Gg, Gs^Vl, Gg^Fms, Gg, Qxu, Gg^Fms, Gg^Fms, Gg^Fds, Gg^Fms, Gg, Qxu, Gg, Gg^Fds, Gs, Gg, Gg, Ch, Ch, Ch, Gg, Re, Rb, Gs, Rb, Ds, Rb, Re, Gs, Gs, Gg, Rb^Gvs, Rb^Gvs, Rb^Gvs, Rb^Gvs, Gg, Rb^Gvs, Gg, Gg, Gg, Gg
Hh^Qhu, Hh, Hh, Hh, Gg, Rr, Rr, Rr^Cov, Rr^Kov, Rr^Cov, Rp, Rp, Rr, Gg, Gg, Gg, Gg, Gg, Gg^Fds, Qxu, Qxu, Gg, Dd, Gg^Fds, Gg, Gg^Fms, Qxu, Gg, Rb, Gg^Fms, Rb, Gg^Fds, Qxu, Gg, Rr, Gg, Gg^Fds, Ch, Re, Kh, Rb, Rb, Ds, Ds, Ds, Ds, Ds, Ds, Rb, Gg, Gs, Gg^Gvs, Rb^Gvs, Rb^Gvs, Rb^Gvs, Rb^Gvs, Rb, Rb^Vh, Re, Re, Rb^Vh, Rb
Rb^Qhu, Gs^Qhu, Re^Qhu, Re^Qhu, Rb^Qhu, Gg^Edt, Gg, Rr, Rp, Rr^Edt, Rr^Edt, Rr^Edt, Rr, Qxu, Qxu, Gg, Rp, Gg, Rb, Rb, Gg, Rb, Dd, Rb, Qxu, Qxu, Rb, Rb, Gg^Fds, Rb, Qxu, Qxu, Qxu, Rr^Vhc, Rr, Rb, Rb^Ebn, Re, Rr^Vhc, Rb, Re, Gg, Ww^Qhu, Ww^Qhu, Ww^Qhu, Wo^Qhu, Wo^Qhu, Ds, Ds, Rb, Rb, Re, Re, Rb^Gvs, Rb^Gvs, Rb^Gvs, Rb^Gvs, Gg, Gg, Re, Gg, Gg
Re^Qhu, Re^Gvs, Re^Gvs, Rb^Gvs, Gg^Efm, Gs^Qhu, Hh^Qhu, Gg, Hh, Rp^Edt, Rp, Rp, Rp, Rr^Cov, Rr^Kov, Qxu, Qxu, Rp, Gg, Gg^Fds, Dd^Xo, Gg^Xo, Dd^Xo, Dd^Fdw, Dd^Fdw, Rb, Gg^Fms, Gg^Fms, Dd^Fdw, Qxu, Qxu, Qxu, Qxu, Rb, Gg, Rr, Rr, Rr, Gs, Gs, Re^Vh, Rb^Vh, Ww^Qhu, Ww, Ww, Ww, Wo^Qhu, Dd, Dd^Edt, Gs, Gg^Edt, Rb^Vh, Rb, Rb^Gvs, Re^Gvs, Rb^Gvs, Rb^Gvs, Rb^Gvs, Rb^Gvs, Rb^Gvs, Rb^Gvs, Rb^Gvs
Re^Gvs, Rb^Gvs, Re^Gvs, Re^Gvs, Rb^Vh, Gs^Efm, Gg^Efm, Hh^Qhu, Gg^Qhu, Gg, Gs, Gs, Gg, Rr, Rr^Cov, Rr, Rr, Rr, Rr^Xo, Dd^Fdw, Dd^Xo, Qxu, Qxu, Dd^Xo, Dd^Xo, Rb, Dd^Xo, Dd^Fdw, Ww^Qhu, Gg, Qxu, Ds, Ds, Ds, Qxu, Rr^Vhc, Ds, Rr, Ww^Bw\, Ww^Qhu, Ww^Qhu, Ww^Qhu, Ww, Ww, Ww, Ww, Wo, Wo^Qhu, Gs^Edt, Cer, Gs, Cer, Gg^Edt, Rb, Re^Gvs, Re^Gvs, Rb^Gvs, Rb^Gvs, Rb^Gvs, Rb^Gvs, Rb^Gvs, Rb^Gvs
Rb^Gvs, Re^Gvs, Re^Gvs, Re^Gvs, Gg, Rb, Re, Gg, Rb^Vh, Gg^Qhu, Gg^Qhu, Gs, Gs, Rr, Rp, Rr^Edt, Rr^Edt, Rp^Xo, Qxu, Dd^Xo, Dd^Xo, Dd^Xo, Qxu, Qxu, Qxu, Rb^Xo, Qxu, Dd^Xo, Dd^Xo, Dd^Fdw, Dd^Ewl, Ww, Ww^Qhu, Ww^Qhu, Ww^Qhu, Qxu, Ww^Qhu, Ww^Qhu, Ww^Qhu, Ww^Qhu, Ww, Ww, Ww, Ww, Ww, Wo, Wo^Qhu, Wo^Qhu, Gs, Cer, Ker, Gs, Gg^Edt, Rb, Re^Gvs, Re^Gvs, Rb^Gvs, Rb^Gvs, Rb^Gvs, Rb^Gvs, Re^Gvs, Rb^Gvs
Rb^Gvs, Rb^Gvs, Re^Vh, Gg, Re, Re, Rb^Vh, Rb, Gs, Gg, Gg^Qhu, Rb^Gvs, Rb^Gvs, Rb^Gvs, Gg, Rr^Edt, Rp, Rr^Xo, Qxu, Dd^Xo, Dd^Xo, Qxu, Qxu, Dd^Xo, Qxu, Qxu, Urb, Qxu, Gg^Xo, Dd^Qhuf, Qxu, Qxu, Ww^Qhu, Ww^Ewf, Qxu, Ww^Qhu, Qxu, Ww, Ww, Ww, Ww, Ww, Ww, Ww, Wo, Wo, Wo^Qhu, Gs, Cer^Edt, Cer^Edb, Cer^Edt, Cer, Rb, Rb^Gvs, Rb^Gvs, Rb^Gvs, Rb^Gvs, Rb^Gvs, Rb^Gvs, Re^Gvs, Re^Gvs, Rb^Gvs
Gg^Gvs, Gg, Gg, Re, Gg, Gg, Rb, Gs^Efm, Rb^Gvs, Gs, Rb^Qhu, Rb^Gvs, Rb^Gvs, Qxu, Qxu, Gs, Qxu, Rp^Xo, Rp^Xo, Qxu, Qxu, Qxu, Urb, Qxu, Qxu, Sm^Qhu, Qxu, Qxu, Qxu, Dd^Xo, Dd^Xo, Qxu, Wo^Qhu, Ww, Wo, Qxu, Ww, Ww, Wo, Ww, Wo, Ww, Wo, Wo, Wo^Qhu, Wo^Qhu, Gs, Gs^Edt, Gs, Gs, Gg, Gg, Rb^Gvs, Rb^Gvs, Rb^Gvs, Rb^Gvs, Rb^Vh, Gg, Gg, Rb^Gvs, Rb^Gvs, Rb^Gvs
Rb^Gvs, Re^Gvs, Rb^Gvs, Gg^Gvs, Rb^Gvs, Rb^Gvs, Rb^Gvs, Rb^Gvs, Re^Gvs, Re^Gvs, Re^Gvs, Re^Qhu, Re^Qhu, Rb^Gvs, Rb^Gvs, Qxu, Qxu, Qxu, Dd^Xo, Qxu, Rp^Xo, Qxu, Sm^Qhu, Urb, Cud, Kud, Qxu, Qxu, Dd^Xo, Qxu, Dd^Xo, Dd, Dd^Xo, Wo^Qhu, Wo^Qhu, Wo^Qhu, Wo^Qhu, Wo, Wo^Qhu, Wo^_ml, Wo^Qhu, Wo^Qhu, Wo^Qhu, Wo, Wo^Qhu, Gg, Gs^Edt, Gs, Gg^Gvs, Gg, Re^Gvs, Re^Gvs, Rb^Gvs, Rb^Gvs, Rb^Gvs, Gg, Rb, Rb, Rb^Gvs, Gg, Rb^Gvs, Rb^Gvs
Gg, Re^Gvs, Re^Gvs, Re^Gvs, Re, Rb^Gvs, Rb^Gvs, Rb^Gvs, Re^Gvs, Re^Gvs, Re^Gvs, Re^Gvs, Rb^Gvs, Hhd^Qhu, Hhd^Qhu, Dd, Dd, Dd, Dd^Xo, Rr^Xo, Qxu, Qxu, Cud, Qxu, Urb, Urb^Qhu, Urb, Qxu, Qxu, Dd^Xo, Dd^Xo, Dd^Xo, Qxu, Gg^Xo, Qxu, Dd^Qhu, Dd^Qhu, Wo^Qhu, Rb, Wo^Qhu, Rb, Rb, Rp, Wo^Qhu, Rr^Edt, Gs, Gg, Gg, Re^Gvs, Re^Gvs, Rb^Gvs, Rb^Gvs, Rb^Gvs, Rb^Gvs, Re^Gvs, Rb^Gvs, Re^Gvs, Re^Gvs, Re^Gvs, Re^Gvs, Rb^Gvs, Rb^Gvs
Gg^Gvs, Re^Gvs, Re^Gvs, Re, Gs, Gs, Gs, Gg, Rb^Gvs, Re^Gvs, Re^Gvs, Re^Gvs, Qxu, Gs, Dd^Qhu, Dd, Dd, Dd^Xo, Qxu, Qxu, Qxu, Kud, Cud, Sm, Kud, Sm, Sm^Qhu, Cud, Qxu, Qxu, Qxu, Qxu, Dd^Xo, Dd^Xo, Qxu, Qxu, Qxu, Qxu, Rr, Rb, Rr, Rp^Edt, Rr^Kov, Rp, Rp, Rp^Edt, Rp, Re^Gvs, Rb, Rb^Gvs, Gg, Rb^Gvs, Rb, Re^Gvs, Rb^Gvs, Re^Gvs, Rb^Gvs, Rb^Gvs, Rb^Gvs, Rb^Gvs, Gg^Gvs, Gg^Gvs
Gg^Gvs, Re^Gvs, Re^Gvs, Rb^Gvs, Gs, Rb^Vh, Re, Re, Gg, Rb^Gvs, Gg^Efm, Qxu, Re^Gvs, Qxu, Qxu, Dd^Qhu, Gg^Qhu, Dd^Xo, Qxu, Sm^Qhu, Urb, Urb, Qxu, Urb^Qhh, Urb, Sm^Qhu, Cud, Urb, Urb, Urb, Qxu, Rr^Xo, Dd^Xo, Rr, Qxu, Qxu, Qxu, Rp, Rp, Rr, Rp^Edt, Rr^Cov, Rr, Rr^Cov, Rp, Rp, Rr^Edt, Rp, Rr, Gg, Rr^Edt, Rp, Gg, Rb, Rb, Rb, Gg, Rb^Vh, Gg, Gg, Gg, Rb^Gvs
Gg, Gg, Re^Gvs, Rb^Gvs, Rb^Gvs, Gg, Gs, Re, Re, Gg^Efm, Rb^Vh, Gg^Efm, Qxu, Qxu^Qhu, Gs^Qhu, Dd^Qhu, Gg^Qhu, Rb^Xo, Dd^Xo, Qxu, Qxu, Qxu, Qxu, Qxu, Sm, Cud, Kud, Urb^Qhu, Qxu, Qxua, Qxu, Qxu, Dd^Xo, Dd, Rp, Dd, Qxu, Rr, Rr, Rr^Edt, Rb, Re^Vh, Re, Rr, Gs, Rr^Edt, Rp, Rr^Edt, Rr, Rp, Rr^Cov, Rp, Rp, Rr^Edt, Rp^Edt, Gg, Gg, Gg, Gg, Rp, Gg, Gg
Rb^Gvs, Rb, Gg, Rb, Rb, Rb^Gvs, Gs^Efm, Rb^Vh, Gg^Efm, Rb, Gg^Efm, Gg^Efm, Gg^Efm, Qxu, Rb^Gvs, Qxu, Dd^Qhu, Dd, Dd^Xo, Qxu, Qxu, Dd^Xo, Qxu, Sm^Qhu, Qxu, Qxu, Qxu, Qxu, Qxu, Dd^Xo, Qxu, Qxu, Qxu, Dd^Xo, Qxu, Qxu, Rp, Qxu, Qxu, Qxu, Re, Gs, Re, Re, Rb^Edt, Rb^Vh, Rp, Rp, Rp, Rr, Rr^Kov, Rr^Cov, Rr, Rp, Rr^Edt, Rr, Rr, Rp, Rp, Rp^Edt, Gg, Gg
Rb^Gvs, Re^Gvs, Rb^_ml, Gg, Gg, Gg, Gs, Gs^Efm, Rb^Gvs, Rb^Gvs, Rb^Gvs, Rb^Gvs, Rb^Gvs, Re^Gvs, Re^Qhu, Re^Qhu, Rb^Gvs, Rb, Rb^Xo, Qxu, Dd^Xo, Dd^Xo, Qxu, Urb^Qhu, Qxu, Gs^Xo, Dd^Xo, Qxu, Qxu, Dd^Xo, Dd^Xo, Dd^Xo, Gg^Xo, Dd^Xo, Qxu, Gg, Gg^Efm, Gg, Gg^Efm, Gg, Gg, Re, Gg^Efm, Rb^Vh, Gg, Gs, Gs, Rp^Edt, Rp, Rr, Rr, Rr, Rr, Rr, Rr, Rp, Rr^Kov, Rr^Cov, Rr^Cov, Rp^Edt, Rp, Gg
Rb^Gvs, Rb^Gvs, Rb^Gvs, Gg^Gvs, Gg, Gg, Gg, Rb^Gvs, Re^Gvs, Rb^Gvs, Re^Gvs, Rb^Gvs, Rb^Gvs, Re^Gvs, Re^Qhu, Rb^Gvs, Rb^Gvs, Rb, Dd^Qhu, Dd^Xo, Rb^Qhu, Qxu^Xo, Rb^Xo, Qxu, Qxu, Hd^Xo, Hd^Xo, Hh^Xo, Hh^Xo, Qxu, Hh^Xo, Dd, Gg, Gg^Efm, Gg, Gg^Efm, Gg, Gg^Efm, Gg, Gg^Efm, Gg, Gg^Efm, Gg, Gg^Efm, Gg^Efm, Gg, Gg, Gs, Gg^Efm, Gg^Efm, Gg, Gg, Gg, Gg^Edt, Gg, Rr, Rr, Rr, Rr, Rr, Rr, Rr
